id,scan_t1ce,scan_t2,scan_flair,scan_t1,label,center_x,center_y,center_z,x_extreme_min,x_extreme_max,y_extreme_min,y_extreme_max,z_extreme_min,z_extreme_max,x_size,y_size,z_size
01488-000,../../DataSet/ASNR-MICCAI-BraTS2023-GLI-Challenge-TrainingData/BraTS-GLI-01488-000/BraTS-GLI-01488-000-t1c.nii.gz,../../DataSet/ASNR-MICCAI-BraTS2023-GLI-Challenge-TrainingData/BraTS-GLI-01488-000/BraTS-GLI-01488-000-t2w.nii.gz,../../DataSet/ASNR-MICCAI-BraTS2023-GLI-Challenge-TrainingData/BraTS-GLI-01488-000/BraTS-GLI-01488-000-t2f.nii.gz,../../DataSet/ASNR-MICCAI-BraTS2023-GLI-Challenge-TrainingData/BraTS-GLI-01488-000/BraTS-GLI-01488-000-t1n.nii.gz,../../DataSet/ASNR-MICCAI-BraTS2023-GLI-Challenge-TrainingData/BraTS-GLI-01488-000/BraTS-GLI-01488-000-seg.nii.gz,104,158,110,80,123,128,183,81,137,43,55,56
00219-000,../../DataSet/ASNR-MICCAI-BraTS2023-GLI-Challenge-TrainingData/BraTS-GLI-00219-000/BraTS-GLI-00219-000-t1c.nii.gz,../../DataSet/ASNR-MICCAI-BraTS2023-GLI-Challenge-TrainingData/BraTS-GLI-00219-000/BraTS-GLI-00219-000-t2w.nii.gz,../../DataSet/ASNR-MICCAI-BraTS2023-GLI-Challenge-TrainingData/BraTS-GLI-00219-000/BraTS-GLI-00219-000-t2f.nii.gz,../../DataSet/ASNR-MICCAI-BraTS2023-GLI-Challenge-TrainingData/BraTS-GLI-00219-000/BraTS-GLI-00219-000-t1n.nii.gz,../../DataSet/ASNR-MICCAI-BraTS2023-GLI-Challenge-TrainingData/BraTS-GLI-00219-000/BraTS-GLI-00219-000-seg.nii.gz,140,124,83,127,170,103,145,63,98,43,42,35
01459-000,../../DataSet/ASNR-MICCAI-BraTS2023-GLI-Challenge-TrainingData/BraTS-GLI-01459-000/BraTS-GLI-01459-000-t1c.nii.gz,../../DataSet/ASNR-MICCAI-BraTS2023-GLI-Challenge-TrainingData/BraTS-GLI-01459-000/BraTS-GLI-01459-000-t2w.nii.gz,../../DataSet/ASNR-MICCAI-BraTS2023-GLI-Challenge-TrainingData/BraTS-GLI-01459-000/BraTS-GLI-01459-000-t2f.nii.gz,../../DataSet/ASNR-MICCAI-BraTS2023-GLI-Challenge-TrainingData/BraTS-GLI-01459-000/BraTS-GLI-01459-000-t1n.nii.gz,../../DataSet/ASNR-MICCAI-BraTS2023-GLI-Challenge-TrainingData/BraTS-GLI-01459-000/BraTS-GLI-01459-000-seg.nii.gz,153,181,51,128,175,149,201,20,71,47,52,51
01038-000,../../DataSet/ASNR-MICCAI-BraTS2023-GLI-Challenge-TrainingData/BraTS-GLI-01038-000/BraTS-GLI-01038-000-t1c.nii.gz,../../DataSet/ASNR-MICCAI-BraTS2023-GLI-Challenge-TrainingData/BraTS-GLI-01038-000/BraTS-GLI-01038-000-t2w.nii.gz,../../DataSet/ASNR-MICCAI-BraTS2023-GLI-Challenge-TrainingData/BraTS-GLI-01038-000/BraTS-GLI-01038-000-t2f.nii.gz,../../DataSet/ASNR-MICCAI-BraTS2023-GLI-Challenge-TrainingData/BraTS-GLI-01038-000/BraTS-GLI-01038-000-t1n.nii.gz,../../DataSet/ASNR-MICCAI-BraTS2023-GLI-Challenge-TrainingData/BraTS-GLI-01038-000/BraTS-GLI-01038-000-seg.nii.gz,148,170,71,117,179,138,207,41,103,62,69,62
00341-000,../../DataSet/ASNR-MICCAI-BraTS2023-GLI-Challenge-TrainingData/BraTS-GLI-00341-000/BraTS-GLI-00341-000-t1c.nii.gz,../../DataSet/ASNR-MICCAI-BraTS2023-GLI-Challenge-TrainingData/BraTS-GLI-00341-000/BraTS-GLI-00341-000-t2w.nii.gz,../../DataSet/ASNR-MICCAI-BraTS2023-GLI-Challenge-TrainingData/BraTS-GLI-00341-000/BraTS-GLI-00341-000-t2f.nii.gz,../../DataSet/ASNR-MICCAI-BraTS2023-GLI-Challenge-TrainingData/BraTS-GLI-00341-000/BraTS-GLI-00341-000-t1n.nii.gz,../../DataSet/ASNR-MICCAI-BraTS2023-GLI-Challenge-TrainingData/BraTS-GLI-00341-000/BraTS-GLI-00341-000-seg.nii.gz,138,171,85,120,160,135,201,62,112,40,66,50
01501-000,../../DataSet/ASNR-MICCAI-BraTS2023-GLI-Challenge-TrainingData/BraTS-GLI-01501-000/BraTS-GLI-01501-000-t1c.nii.gz,../../DataSet/ASNR-MICCAI-BraTS2023-GLI-Challenge-TrainingData/BraTS-GLI-01501-000/BraTS-GLI-01501-000-t2w.nii.gz,../../DataSet/ASNR-MICCAI-BraTS2023-GLI-Challenge-TrainingData/BraTS-GLI-01501-000/BraTS-GLI-01501-000-t2f.nii.gz,../../DataSet/ASNR-MICCAI-BraTS2023-GLI-Challenge-TrainingData/BraTS-GLI-01501-000/BraTS-GLI-01501-000-t1n.nii.gz,../../DataSet/ASNR-MICCAI-BraTS2023-GLI-Challenge-TrainingData/BraTS-GLI-01501-000/BraTS-GLI-01501-000-seg.nii.gz,153,133,63,113,183,86,181,33,97,70,95,64
00087-000,../../DataSet/ASNR-MICCAI-BraTS2023-GLI-Challenge-TrainingData/BraTS-GLI-00087-000/BraTS-GLI-00087-000-t1c.nii.gz,../../DataSet/ASNR-MICCAI-BraTS2023-GLI-Challenge-TrainingData/BraTS-GLI-00087-000/BraTS-GLI-00087-000-t2w.nii.gz,../../DataSet/ASNR-MICCAI-BraTS2023-GLI-Challenge-TrainingData/BraTS-GLI-00087-000/BraTS-GLI-00087-000-t2f.nii.gz,../../DataSet/ASNR-MICCAI-BraTS2023-GLI-Challenge-TrainingData/BraTS-GLI-00087-000/BraTS-GLI-00087-000-t1n.nii.gz,../../DataSet/ASNR-MICCAI-BraTS2023-GLI-Challenge-TrainingData/BraTS-GLI-00087-000/BraTS-GLI-00087-000-seg.nii.gz,146,124,67,113,174,88,175,27,108,61,87,81
00056-000,../../DataSet/ASNR-MICCAI-BraTS2023-GLI-Challenge-TrainingData/BraTS-GLI-00056-000/BraTS-GLI-00056-000-t1c.nii.gz,../../DataSet/ASNR-MICCAI-BraTS2023-GLI-Challenge-TrainingData/BraTS-GLI-00056-000/BraTS-GLI-00056-000-t2w.nii.gz,../../DataSet/ASNR-MICCAI-BraTS2023-GLI-Challenge-TrainingData/BraTS-GLI-00056-000/BraTS-GLI-00056-000-t2f.nii.gz,../../DataSet/ASNR-MICCAI-BraTS2023-GLI-Challenge-TrainingData/BraTS-GLI-00056-000/BraTS-GLI-00056-000-t1n.nii.gz,../../DataSet/ASNR-MICCAI-BraTS2023-GLI-Challenge-TrainingData/BraTS-GLI-00056-000/BraTS-GLI-00056-000-seg.nii.gz,155,117,68,125,183,79,163,38,97,58,84,59
01277-000,../../DataSet/ASNR-MICCAI-BraTS2023-GLI-Challenge-TrainingData/BraTS-GLI-01277-000/BraTS-GLI-01277-000-t1c.nii.gz,../../DataSet/ASNR-MICCAI-BraTS2023-GLI-Challenge-TrainingData/BraTS-GLI-01277-000/BraTS-GLI-01277-000-t2w.nii.gz,../../DataSet/ASNR-MICCAI-BraTS2023-GLI-Challenge-TrainingData/BraTS-GLI-01277-000/BraTS-GLI-01277-000-t2f.nii.gz,../../DataSet/ASNR-MICCAI-BraTS2023-GLI-Challenge-TrainingData/BraTS-GLI-01277-000/BraTS-GLI-01277-000-t1n.nii.gz,../../DataSet/ASNR-MICCAI-BraTS2023-GLI-Challenge-TrainingData/BraTS-GLI-01277-000/BraTS-GLI-01277-000-seg.nii.gz,155,145,65,125,185,108,180,35,96,60,72,61
00390-000,../../DataSet/ASNR-MICCAI-BraTS2023-GLI-Challenge-TrainingData/BraTS-GLI-00390-000/BraTS-GLI-00390-000-t1c.nii.gz,../../DataSet/ASNR-MICCAI-BraTS2023-GLI-Challenge-TrainingData/BraTS-GLI-00390-000/BraTS-GLI-00390-000-t2w.nii.gz,../../DataSet/ASNR-MICCAI-BraTS2023-GLI-Challenge-TrainingData/BraTS-GLI-00390-000/BraTS-GLI-00390-000-t2f.nii.gz,../../DataSet/ASNR-MICCAI-BraTS2023-GLI-Challenge-TrainingData/BraTS-GLI-00390-000/BraTS-GLI-00390-000-t1n.nii.gz,../../DataSet/ASNR-MICCAI-BraTS2023-GLI-Challenge-TrainingData/BraTS-GLI-00390-000/BraTS-GLI-00390-000-seg.nii.gz,168,116,55,98,184,79,142,35,90,86,63,55
00172-000,../../DataSet/ASNR-MICCAI-BraTS2023-GLI-Challenge-TrainingData/BraTS-GLI-00172-000/BraTS-GLI-00172-000-t1c.nii.gz,../../DataSet/ASNR-MICCAI-BraTS2023-GLI-Challenge-TrainingData/BraTS-GLI-00172-000/BraTS-GLI-00172-000-t2w.nii.gz,../../DataSet/ASNR-MICCAI-BraTS2023-GLI-Challenge-TrainingData/BraTS-GLI-00172-000/BraTS-GLI-00172-000-t2f.nii.gz,../../DataSet/ASNR-MICCAI-BraTS2023-GLI-Challenge-TrainingData/BraTS-GLI-00172-000/BraTS-GLI-00172-000-t1n.nii.gz,../../DataSet/ASNR-MICCAI-BraTS2023-GLI-Challenge-TrainingData/BraTS-GLI-00172-000/BraTS-GLI-00172-000-seg.nii.gz,159,141,68,109,187,93,189,32,101,78,96,69
01353-000,../../DataSet/ASNR-MICCAI-BraTS2023-GLI-Challenge-TrainingData/BraTS-GLI-01353-000/BraTS-GLI-01353-000-t1c.nii.gz,../../DataSet/ASNR-MICCAI-BraTS2023-GLI-Challenge-TrainingData/BraTS-GLI-01353-000/BraTS-GLI-01353-000-t2w.nii.gz,../../DataSet/ASNR-MICCAI-BraTS2023-GLI-Challenge-TrainingData/BraTS-GLI-01353-000/BraTS-GLI-01353-000-t2f.nii.gz,../../DataSet/ASNR-MICCAI-BraTS2023-GLI-Challenge-TrainingData/BraTS-GLI-01353-000/BraTS-GLI-01353-000-t1n.nii.gz,../../DataSet/ASNR-MICCAI-BraTS2023-GLI-Challenge-TrainingData/BraTS-GLI-01353-000/BraTS-GLI-01353-000-seg.nii.gz,151,115,56,128,172,67,151,31,81,44,84,50
00513-000,../../DataSet/ASNR-MICCAI-BraTS2023-GLI-Challenge-TrainingData/BraTS-GLI-00513-000/BraTS-GLI-00513-000-t1c.nii.gz,../../DataSet/ASNR-MICCAI-BraTS2023-GLI-Challenge-TrainingData/BraTS-GLI-00513-000/BraTS-GLI-00513-000-t2w.nii.gz,../../DataSet/ASNR-MICCAI-BraTS2023-GLI-Challenge-TrainingData/BraTS-GLI-00513-000/BraTS-GLI-00513-000-t2f.nii.gz,../../DataSet/ASNR-MICCAI-BraTS2023-GLI-Challenge-TrainingData/BraTS-GLI-00513-000/BraTS-GLI-00513-000-t1n.nii.gz,../../DataSet/ASNR-MICCAI-BraTS2023-GLI-Challenge-TrainingData/BraTS-GLI-00513-000/BraTS-GLI-00513-000-seg.nii.gz,88,112,64,53,130,70,159,25,104,77,89,79
01425-000,../../DataSet/ASNR-MICCAI-BraTS2023-GLI-Challenge-TrainingData/BraTS-GLI-01425-000/BraTS-GLI-01425-000-t1c.nii.gz,../../DataSet/ASNR-MICCAI-BraTS2023-GLI-Challenge-TrainingData/BraTS-GLI-01425-000/BraTS-GLI-01425-000-t2w.nii.gz,../../DataSet/ASNR-MICCAI-BraTS2023-GLI-Challenge-TrainingData/BraTS-GLI-01425-000/BraTS-GLI-01425-000-t2f.nii.gz,../../DataSet/ASNR-MICCAI-BraTS2023-GLI-Challenge-TrainingData/BraTS-GLI-01425-000/BraTS-GLI-01425-000-t1n.nii.gz,../../DataSet/ASNR-MICCAI-BraTS2023-GLI-Challenge-TrainingData/BraTS-GLI-01425-000/BraTS-GLI-01425-000-seg.nii.gz,133,85,90,82,174,43,131,56,136,92,88,80
01382-000,../../DataSet/ASNR-MICCAI-BraTS2023-GLI-Challenge-TrainingData/BraTS-GLI-01382-000/BraTS-GLI-01382-000-t1c.nii.gz,../../DataSet/ASNR-MICCAI-BraTS2023-GLI-Challenge-TrainingData/BraTS-GLI-01382-000/BraTS-GLI-01382-000-t2w.nii.gz,../../DataSet/ASNR-MICCAI-BraTS2023-GLI-Challenge-TrainingData/BraTS-GLI-01382-000/BraTS-GLI-01382-000-t2f.nii.gz,../../DataSet/ASNR-MICCAI-BraTS2023-GLI-Challenge-TrainingData/BraTS-GLI-01382-000/BraTS-GLI-01382-000-t1n.nii.gz,../../DataSet/ASNR-MICCAI-BraTS2023-GLI-Challenge-TrainingData/BraTS-GLI-01382-000/BraTS-GLI-01382-000-seg.nii.gz,91,143,65,70,118,111,173,36,97,48,62,61
00604-000,../../DataSet/ASNR-MICCAI-BraTS2023-GLI-Challenge-TrainingData/BraTS-GLI-00604-000/BraTS-GLI-00604-000-t1c.nii.gz,../../DataSet/ASNR-MICCAI-BraTS2023-GLI-Challenge-TrainingData/BraTS-GLI-00604-000/BraTS-GLI-00604-000-t2w.nii.gz,../../DataSet/ASNR-MICCAI-BraTS2023-GLI-Challenge-TrainingData/BraTS-GLI-00604-000/BraTS-GLI-00604-000-t2f.nii.gz,../../DataSet/ASNR-MICCAI-BraTS2023-GLI-Challenge-TrainingData/BraTS-GLI-00604-000/BraTS-GLI-00604-000-t1n.nii.gz,../../DataSet/ASNR-MICCAI-BraTS2023-GLI-Challenge-TrainingData/BraTS-GLI-00604-000/BraTS-GLI-00604-000-seg.nii.gz,102,100,110,70,141,59,139,81,142,71,80,61
00021-001,../../DataSet/ASNR-MICCAI-BraTS2023-GLI-Challenge-TrainingData/BraTS-GLI-00021-001/BraTS-GLI-00021-001-t1c.nii.gz,../../DataSet/ASNR-MICCAI-BraTS2023-GLI-Challenge-TrainingData/BraTS-GLI-00021-001/BraTS-GLI-00021-001-t2w.nii.gz,../../DataSet/ASNR-MICCAI-BraTS2023-GLI-Challenge-TrainingData/BraTS-GLI-00021-001/BraTS-GLI-00021-001-t2f.nii.gz,../../DataSet/ASNR-MICCAI-BraTS2023-GLI-Challenge-TrainingData/BraTS-GLI-00021-001/BraTS-GLI-00021-001-t1n.nii.gz,../../DataSet/ASNR-MICCAI-BraTS2023-GLI-Challenge-TrainingData/BraTS-GLI-00021-001/BraTS-GLI-00021-001-seg.nii.gz,108,106,70,71,161,66,160,35,109,90,94,74
00518-001,../../DataSet/ASNR-MICCAI-BraTS2023-GLI-Challenge-TrainingData/BraTS-GLI-00518-001/BraTS-GLI-00518-001-t1c.nii.gz,../../DataSet/ASNR-MICCAI-BraTS2023-GLI-Challenge-TrainingData/BraTS-GLI-00518-001/BraTS-GLI-00518-001-t2w.nii.gz,../../DataSet/ASNR-MICCAI-BraTS2023-GLI-Challenge-TrainingData/BraTS-GLI-00518-001/BraTS-GLI-00518-001-t2f.nii.gz,../../DataSet/ASNR-MICCAI-BraTS2023-GLI-Challenge-TrainingData/BraTS-GLI-00518-001/BraTS-GLI-00518-001-t1n.nii.gz,../../DataSet/ASNR-MICCAI-BraTS2023-GLI-Challenge-TrainingData/BraTS-GLI-00518-001/BraTS-GLI-00518-001-seg.nii.gz,153,107,85,129,177,75,141,59,111,48,66,52
00839-000,../../DataSet/ASNR-MICCAI-BraTS2023-GLI-Challenge-TrainingData/BraTS-GLI-00839-000/BraTS-GLI-00839-000-t1c.nii.gz,../../DataSet/ASNR-MICCAI-BraTS2023-GLI-Challenge-TrainingData/BraTS-GLI-00839-000/BraTS-GLI-00839-000-t2w.nii.gz,../../DataSet/ASNR-MICCAI-BraTS2023-GLI-Challenge-TrainingData/BraTS-GLI-00839-000/BraTS-GLI-00839-000-t2f.nii.gz,../../DataSet/ASNR-MICCAI-BraTS2023-GLI-Challenge-TrainingData/BraTS-GLI-00839-000/BraTS-GLI-00839-000-t1n.nii.gz,../../DataSet/ASNR-MICCAI-BraTS2023-GLI-Challenge-TrainingData/BraTS-GLI-00839-000/BraTS-GLI-00839-000-seg.nii.gz,104,185,73,91,117,168,205,53,97,26,37,44
01092-000,../../DataSet/ASNR-MICCAI-BraTS2023-GLI-Challenge-TrainingData/BraTS-GLI-01092-000/BraTS-GLI-01092-000-t1c.nii.gz,../../DataSet/ASNR-MICCAI-BraTS2023-GLI-Challenge-TrainingData/BraTS-GLI-01092-000/BraTS-GLI-01092-000-t2w.nii.gz,../../DataSet/ASNR-MICCAI-BraTS2023-GLI-Challenge-TrainingData/BraTS-GLI-01092-000/BraTS-GLI-01092-000-t2f.nii.gz,../../DataSet/ASNR-MICCAI-BraTS2023-GLI-Challenge-TrainingData/BraTS-GLI-01092-000/BraTS-GLI-01092-000-t1n.nii.gz,../../DataSet/ASNR-MICCAI-BraTS2023-GLI-Challenge-TrainingData/BraTS-GLI-01092-000/BraTS-GLI-01092-000-seg.nii.gz,140,103,87,108,168,59,149,53,127,60,90,74
00750-001,../../DataSet/ASNR-MICCAI-BraTS2023-GLI-Challenge-TrainingData/BraTS-GLI-00750-001/BraTS-GLI-00750-001-t1c.nii.gz,../../DataSet/ASNR-MICCAI-BraTS2023-GLI-Challenge-TrainingData/BraTS-GLI-00750-001/BraTS-GLI-00750-001-t2w.nii.gz,../../DataSet/ASNR-MICCAI-BraTS2023-GLI-Challenge-TrainingData/BraTS-GLI-00750-001/BraTS-GLI-00750-001-t2f.nii.gz,../../DataSet/ASNR-MICCAI-BraTS2023-GLI-Challenge-TrainingData/BraTS-GLI-00750-001/BraTS-GLI-00750-001-t1n.nii.gz,../../DataSet/ASNR-MICCAI-BraTS2023-GLI-Challenge-TrainingData/BraTS-GLI-00750-001/BraTS-GLI-00750-001-seg.nii.gz,96,163,93,71,123,123,209,62,132,52,86,70
01354-000,../../DataSet/ASNR-MICCAI-BraTS2023-GLI-Challenge-TrainingData/BraTS-GLI-01354-000/BraTS-GLI-01354-000-t1c.nii.gz,../../DataSet/ASNR-MICCAI-BraTS2023-GLI-Challenge-TrainingData/BraTS-GLI-01354-000/BraTS-GLI-01354-000-t2w.nii.gz,../../DataSet/ASNR-MICCAI-BraTS2023-GLI-Challenge-TrainingData/BraTS-GLI-01354-000/BraTS-GLI-01354-000-t2f.nii.gz,../../DataSet/ASNR-MICCAI-BraTS2023-GLI-Challenge-TrainingData/BraTS-GLI-01354-000/BraTS-GLI-01354-000-t1n.nii.gz,../../DataSet/ASNR-MICCAI-BraTS2023-GLI-Challenge-TrainingData/BraTS-GLI-01354-000/BraTS-GLI-01354-000-seg.nii.gz,160,141,86,121,183,101,188,56,121,62,87,65
01385-000,../../DataSet/ASNR-MICCAI-BraTS2023-GLI-Challenge-TrainingData/BraTS-GLI-01385-000/BraTS-GLI-01385-000-t1c.nii.gz,../../DataSet/ASNR-MICCAI-BraTS2023-GLI-Challenge-TrainingData/BraTS-GLI-01385-000/BraTS-GLI-01385-000-t2w.nii.gz,../../DataSet/ASNR-MICCAI-BraTS2023-GLI-Challenge-TrainingData/BraTS-GLI-01385-000/BraTS-GLI-01385-000-t2f.nii.gz,../../DataSet/ASNR-MICCAI-BraTS2023-GLI-Challenge-TrainingData/BraTS-GLI-01385-000/BraTS-GLI-01385-000-t1n.nii.gz,../../DataSet/ASNR-MICCAI-BraTS2023-GLI-Challenge-TrainingData/BraTS-GLI-01385-000/BraTS-GLI-01385-000-seg.nii.gz,96,86,88,64,136,48,126,46,134,72,78,88
01422-000,../../DataSet/ASNR-MICCAI-BraTS2023-GLI-Challenge-TrainingData/BraTS-GLI-01422-000/BraTS-GLI-01422-000-t1c.nii.gz,../../DataSet/ASNR-MICCAI-BraTS2023-GLI-Challenge-TrainingData/BraTS-GLI-01422-000/BraTS-GLI-01422-000-t2w.nii.gz,../../DataSet/ASNR-MICCAI-BraTS2023-GLI-Challenge-TrainingData/BraTS-GLI-01422-000/BraTS-GLI-01422-000-t2f.nii.gz,../../DataSet/ASNR-MICCAI-BraTS2023-GLI-Challenge-TrainingData/BraTS-GLI-01422-000/BraTS-GLI-01422-000-t1n.nii.gz,../../DataSet/ASNR-MICCAI-BraTS2023-GLI-Challenge-TrainingData/BraTS-GLI-01422-000/BraTS-GLI-01422-000-seg.nii.gz,156,109,107,141,175,89,128,89,132,34,39,43
00262-000,../../DataSet/ASNR-MICCAI-BraTS2023-GLI-Challenge-TrainingData/BraTS-GLI-00262-000/BraTS-GLI-00262-000-t1c.nii.gz,../../DataSet/ASNR-MICCAI-BraTS2023-GLI-Challenge-TrainingData/BraTS-GLI-00262-000/BraTS-GLI-00262-000-t2w.nii.gz,../../DataSet/ASNR-MICCAI-BraTS2023-GLI-Challenge-TrainingData/BraTS-GLI-00262-000/BraTS-GLI-00262-000-t2f.nii.gz,../../DataSet/ASNR-MICCAI-BraTS2023-GLI-Challenge-TrainingData/BraTS-GLI-00262-000/BraTS-GLI-00262-000-t1n.nii.gz,../../DataSet/ASNR-MICCAI-BraTS2023-GLI-Challenge-TrainingData/BraTS-GLI-00262-000/BraTS-GLI-00262-000-seg.nii.gz,167,129,54,149,182,107,151,40,69,33,44,29
00608-001,../../DataSet/ASNR-MICCAI-BraTS2023-GLI-Challenge-TrainingData/BraTS-GLI-00608-001/BraTS-GLI-00608-001-t1c.nii.gz,../../DataSet/ASNR-MICCAI-BraTS2023-GLI-Challenge-TrainingData/BraTS-GLI-00608-001/BraTS-GLI-00608-001-t2w.nii.gz,../../DataSet/ASNR-MICCAI-BraTS2023-GLI-Challenge-TrainingData/BraTS-GLI-00608-001/BraTS-GLI-00608-001-t2f.nii.gz,../../DataSet/ASNR-MICCAI-BraTS2023-GLI-Challenge-TrainingData/BraTS-GLI-00608-001/BraTS-GLI-00608-001-t1n.nii.gz,../../DataSet/ASNR-MICCAI-BraTS2023-GLI-Challenge-TrainingData/BraTS-GLI-00608-001/BraTS-GLI-00608-001-seg.nii.gz,81,125,86,55,116,88,166,55,117,61,78,62
00109-000,../../DataSet/ASNR-MICCAI-BraTS2023-GLI-Challenge-TrainingData/BraTS-GLI-00109-000/BraTS-GLI-00109-000-t1c.nii.gz,../../DataSet/ASNR-MICCAI-BraTS2023-GLI-Challenge-TrainingData/BraTS-GLI-00109-000/BraTS-GLI-00109-000-t2w.nii.gz,../../DataSet/ASNR-MICCAI-BraTS2023-GLI-Challenge-TrainingData/BraTS-GLI-00109-000/BraTS-GLI-00109-000-t2f.nii.gz,../../DataSet/ASNR-MICCAI-BraTS2023-GLI-Challenge-TrainingData/BraTS-GLI-00109-000/BraTS-GLI-00109-000-t1n.nii.gz,../../DataSet/ASNR-MICCAI-BraTS2023-GLI-Challenge-TrainingData/BraTS-GLI-00109-000/BraTS-GLI-00109-000-seg.nii.gz,153,144,95,125,184,97,190,61,135,59,93,74
00346-000,../../DataSet/ASNR-MICCAI-BraTS2023-GLI-Challenge-TrainingData/BraTS-GLI-00346-000/BraTS-GLI-00346-000-t1c.nii.gz,../../DataSet/ASNR-MICCAI-BraTS2023-GLI-Challenge-TrainingData/BraTS-GLI-00346-000/BraTS-GLI-00346-000-t2w.nii.gz,../../DataSet/ASNR-MICCAI-BraTS2023-GLI-Challenge-TrainingData/BraTS-GLI-00346-000/BraTS-GLI-00346-000-t2f.nii.gz,../../DataSet/ASNR-MICCAI-BraTS2023-GLI-Challenge-TrainingData/BraTS-GLI-00346-000/BraTS-GLI-00346-000-t1n.nii.gz,../../DataSet/ASNR-MICCAI-BraTS2023-GLI-Challenge-TrainingData/BraTS-GLI-00346-000/BraTS-GLI-00346-000-seg.nii.gz,156,131,100,135,178,112,159,79,127,43,47,48
01167-000,../../DataSet/ASNR-MICCAI-BraTS2023-GLI-Challenge-TrainingData/BraTS-GLI-01167-000/BraTS-GLI-01167-000-t1c.nii.gz,../../DataSet/ASNR-MICCAI-BraTS2023-GLI-Challenge-TrainingData/BraTS-GLI-01167-000/BraTS-GLI-01167-000-t2w.nii.gz,../../DataSet/ASNR-MICCAI-BraTS2023-GLI-Challenge-TrainingData/BraTS-GLI-01167-000/BraTS-GLI-01167-000-t2f.nii.gz,../../DataSet/ASNR-MICCAI-BraTS2023-GLI-Challenge-TrainingData/BraTS-GLI-01167-000/BraTS-GLI-01167-000-t1n.nii.gz,../../DataSet/ASNR-MICCAI-BraTS2023-GLI-Challenge-TrainingData/BraTS-GLI-01167-000/BraTS-GLI-01167-000-seg.nii.gz,153,148,87,121,180,102,198,40,121,59,96,81
00397-000,../../DataSet/ASNR-MICCAI-BraTS2023-GLI-Challenge-TrainingData/BraTS-GLI-00397-000/BraTS-GLI-00397-000-t1c.nii.gz,../../DataSet/ASNR-MICCAI-BraTS2023-GLI-Challenge-TrainingData/BraTS-GLI-00397-000/BraTS-GLI-00397-000-t2w.nii.gz,../../DataSet/ASNR-MICCAI-BraTS2023-GLI-Challenge-TrainingData/BraTS-GLI-00397-000/BraTS-GLI-00397-000-t2f.nii.gz,../../DataSet/ASNR-MICCAI-BraTS2023-GLI-Challenge-TrainingData/BraTS-GLI-00397-000/BraTS-GLI-00397-000-t1n.nii.gz,../../DataSet/ASNR-MICCAI-BraTS2023-GLI-Challenge-TrainingData/BraTS-GLI-00397-000/BraTS-GLI-00397-000-seg.nii.gz,92,150,83,60,139,104,198,44,124,79,94,80
01270-000,../../DataSet/ASNR-MICCAI-BraTS2023-GLI-Challenge-TrainingData/BraTS-GLI-01270-000/BraTS-GLI-01270-000-t1c.nii.gz,../../DataSet/ASNR-MICCAI-BraTS2023-GLI-Challenge-TrainingData/BraTS-GLI-01270-000/BraTS-GLI-01270-000-t2w.nii.gz,../../DataSet/ASNR-MICCAI-BraTS2023-GLI-Challenge-TrainingData/BraTS-GLI-01270-000/BraTS-GLI-01270-000-t2f.nii.gz,../../DataSet/ASNR-MICCAI-BraTS2023-GLI-Challenge-TrainingData/BraTS-GLI-01270-000/BraTS-GLI-01270-000-t1n.nii.gz,../../DataSet/ASNR-MICCAI-BraTS2023-GLI-Challenge-TrainingData/BraTS-GLI-01270-000/BraTS-GLI-01270-000-seg.nii.gz,143,99,78,105,175,53,147,32,125,70,94,93
00498-001,../../DataSet/ASNR-MICCAI-BraTS2023-GLI-Challenge-TrainingData/BraTS-GLI-00498-001/BraTS-GLI-00498-001-t1c.nii.gz,../../DataSet/ASNR-MICCAI-BraTS2023-GLI-Challenge-TrainingData/BraTS-GLI-00498-001/BraTS-GLI-00498-001-t2w.nii.gz,../../DataSet/ASNR-MICCAI-BraTS2023-GLI-Challenge-TrainingData/BraTS-GLI-00498-001/BraTS-GLI-00498-001-t2f.nii.gz,../../DataSet/ASNR-MICCAI-BraTS2023-GLI-Challenge-TrainingData/BraTS-GLI-00498-001/BraTS-GLI-00498-001-t1n.nii.gz,../../DataSet/ASNR-MICCAI-BraTS2023-GLI-Challenge-TrainingData/BraTS-GLI-00498-001/BraTS-GLI-00498-001-seg.nii.gz,157,117,63,127,187,84,166,39,96,60,82,57
00493-000,../../DataSet/ASNR-MICCAI-BraTS2023-GLI-Challenge-TrainingData/BraTS-GLI-00493-000/BraTS-GLI-00493-000-t1c.nii.gz,../../DataSet/ASNR-MICCAI-BraTS2023-GLI-Challenge-TrainingData/BraTS-GLI-00493-000/BraTS-GLI-00493-000-t2w.nii.gz,../../DataSet/ASNR-MICCAI-BraTS2023-GLI-Challenge-TrainingData/BraTS-GLI-00493-000/BraTS-GLI-00493-000-t2f.nii.gz,../../DataSet/ASNR-MICCAI-BraTS2023-GLI-Challenge-TrainingData/BraTS-GLI-00493-000/BraTS-GLI-00493-000-t1n.nii.gz,../../DataSet/ASNR-MICCAI-BraTS2023-GLI-Challenge-TrainingData/BraTS-GLI-00493-000/BraTS-GLI-00493-000-seg.nii.gz,132,124,69,97,162,105,145,53,94,65,40,41
00511-001,../../DataSet/ASNR-MICCAI-BraTS2023-GLI-Challenge-TrainingData/BraTS-GLI-00511-001/BraTS-GLI-00511-001-t1c.nii.gz,../../DataSet/ASNR-MICCAI-BraTS2023-GLI-Challenge-TrainingData/BraTS-GLI-00511-001/BraTS-GLI-00511-001-t2w.nii.gz,../../DataSet/ASNR-MICCAI-BraTS2023-GLI-Challenge-TrainingData/BraTS-GLI-00511-001/BraTS-GLI-00511-001-t2f.nii.gz,../../DataSet/ASNR-MICCAI-BraTS2023-GLI-Challenge-TrainingData/BraTS-GLI-00511-001/BraTS-GLI-00511-001-t1n.nii.gz,../../DataSet/ASNR-MICCAI-BraTS2023-GLI-Challenge-TrainingData/BraTS-GLI-00511-001/BraTS-GLI-00511-001-seg.nii.gz,158,121,56,128,187,78,168,22,87,59,90,65
00334-000,../../DataSet/ASNR-MICCAI-BraTS2023-GLI-Challenge-TrainingData/BraTS-GLI-00334-000/BraTS-GLI-00334-000-t1c.nii.gz,../../DataSet/ASNR-MICCAI-BraTS2023-GLI-Challenge-TrainingData/BraTS-GLI-00334-000/BraTS-GLI-00334-000-t2w.nii.gz,../../DataSet/ASNR-MICCAI-BraTS2023-GLI-Challenge-TrainingData/BraTS-GLI-00334-000/BraTS-GLI-00334-000-t2f.nii.gz,../../DataSet/ASNR-MICCAI-BraTS2023-GLI-Challenge-TrainingData/BraTS-GLI-00334-000/BraTS-GLI-00334-000-t1n.nii.gz,../../DataSet/ASNR-MICCAI-BraTS2023-GLI-Challenge-TrainingData/BraTS-GLI-00334-000/BraTS-GLI-00334-000-seg.nii.gz,101,144,78,79,129,114,179,54,104,50,65,50
01115-000,../../DataSet/ASNR-MICCAI-BraTS2023-GLI-Challenge-TrainingData/BraTS-GLI-01115-000/BraTS-GLI-01115-000-t1c.nii.gz,../../DataSet/ASNR-MICCAI-BraTS2023-GLI-Challenge-TrainingData/BraTS-GLI-01115-000/BraTS-GLI-01115-000-t2w.nii.gz,../../DataSet/ASNR-MICCAI-BraTS2023-GLI-Challenge-TrainingData/BraTS-GLI-01115-000/BraTS-GLI-01115-000-t2f.nii.gz,../../DataSet/ASNR-MICCAI-BraTS2023-GLI-Challenge-TrainingData/BraTS-GLI-01115-000/BraTS-GLI-01115-000-t1n.nii.gz,../../DataSet/ASNR-MICCAI-BraTS2023-GLI-Challenge-TrainingData/BraTS-GLI-01115-000/BraTS-GLI-01115-000-seg.nii.gz,160,155,62,133,185,108,195,37,97,52,87,60
01663-000,../../DataSet/ASNR-MICCAI-BraTS2023-GLI-Challenge-TrainingData/BraTS-GLI-01663-000/BraTS-GLI-01663-000-t1c.nii.gz,../../DataSet/ASNR-MICCAI-BraTS2023-GLI-Challenge-TrainingData/BraTS-GLI-01663-000/BraTS-GLI-01663-000-t2w.nii.gz,../../DataSet/ASNR-MICCAI-BraTS2023-GLI-Challenge-TrainingData/BraTS-GLI-01663-000/BraTS-GLI-01663-000-t2f.nii.gz,../../DataSet/ASNR-MICCAI-BraTS2023-GLI-Challenge-TrainingData/BraTS-GLI-01663-000/BraTS-GLI-01663-000-t1n.nii.gz,../../DataSet/ASNR-MICCAI-BraTS2023-GLI-Challenge-TrainingData/BraTS-GLI-01663-000/BraTS-GLI-01663-000-seg.nii.gz,143,101,110,124,173,70,131,87,136,49,61,49
00830-000,../../DataSet/ASNR-MICCAI-BraTS2023-GLI-Challenge-TrainingData/BraTS-GLI-00830-000/BraTS-GLI-00830-000-t1c.nii.gz,../../DataSet/ASNR-MICCAI-BraTS2023-GLI-Challenge-TrainingData/BraTS-GLI-00830-000/BraTS-GLI-00830-000-t2w.nii.gz,../../DataSet/ASNR-MICCAI-BraTS2023-GLI-Challenge-TrainingData/BraTS-GLI-00830-000/BraTS-GLI-00830-000-t2f.nii.gz,../../DataSet/ASNR-MICCAI-BraTS2023-GLI-Challenge-TrainingData/BraTS-GLI-00830-000/BraTS-GLI-00830-000-t1n.nii.gz,../../DataSet/ASNR-MICCAI-BraTS2023-GLI-Challenge-TrainingData/BraTS-GLI-00830-000/BraTS-GLI-00830-000-seg.nii.gz,133,107,104,100,155,70,150,75,134,55,80,59
00442-000,../../DataSet/ASNR-MICCAI-BraTS2023-GLI-Challenge-TrainingData/BraTS-GLI-00442-000/BraTS-GLI-00442-000-t1c.nii.gz,../../DataSet/ASNR-MICCAI-BraTS2023-GLI-Challenge-TrainingData/BraTS-GLI-00442-000/BraTS-GLI-00442-000-t2w.nii.gz,../../DataSet/ASNR-MICCAI-BraTS2023-GLI-Challenge-TrainingData/BraTS-GLI-00442-000/BraTS-GLI-00442-000-t2f.nii.gz,../../DataSet/ASNR-MICCAI-BraTS2023-GLI-Challenge-TrainingData/BraTS-GLI-00442-000/BraTS-GLI-00442-000-t1n.nii.gz,../../DataSet/ASNR-MICCAI-BraTS2023-GLI-Challenge-TrainingData/BraTS-GLI-00442-000/BraTS-GLI-00442-000-seg.nii.gz,106,125,101,69,135,85,149,78,129,66,64,51
00107-000,../../DataSet/ASNR-MICCAI-BraTS2023-GLI-Challenge-TrainingData/BraTS-GLI-00107-000/BraTS-GLI-00107-000-t1c.nii.gz,../../DataSet/ASNR-MICCAI-BraTS2023-GLI-Challenge-TrainingData/BraTS-GLI-00107-000/BraTS-GLI-00107-000-t2w.nii.gz,../../DataSet/ASNR-MICCAI-BraTS2023-GLI-Challenge-TrainingData/BraTS-GLI-00107-000/BraTS-GLI-00107-000-t2f.nii.gz,../../DataSet/ASNR-MICCAI-BraTS2023-GLI-Challenge-TrainingData/BraTS-GLI-00107-000/BraTS-GLI-00107-000-t1n.nii.gz,../../DataSet/ASNR-MICCAI-BraTS2023-GLI-Challenge-TrainingData/BraTS-GLI-00107-000/BraTS-GLI-00107-000-seg.nii.gz,156,113,88,130,180,79,145,60,115,50,66,55
01481-000,../../DataSet/ASNR-MICCAI-BraTS2023-GLI-Challenge-TrainingData/BraTS-GLI-01481-000/BraTS-GLI-01481-000-t1c.nii.gz,../../DataSet/ASNR-MICCAI-BraTS2023-GLI-Challenge-TrainingData/BraTS-GLI-01481-000/BraTS-GLI-01481-000-t2w.nii.gz,../../DataSet/ASNR-MICCAI-BraTS2023-GLI-Challenge-TrainingData/BraTS-GLI-01481-000/BraTS-GLI-01481-000-t2f.nii.gz,../../DataSet/ASNR-MICCAI-BraTS2023-GLI-Challenge-TrainingData/BraTS-GLI-01481-000/BraTS-GLI-01481-000-t1n.nii.gz,../../DataSet/ASNR-MICCAI-BraTS2023-GLI-Challenge-TrainingData/BraTS-GLI-01481-000/BraTS-GLI-01481-000-seg.nii.gz,90,143,98,63,119,104,174,69,124,56,70,55
01326-000,../../DataSet/ASNR-MICCAI-BraTS2023-GLI-Challenge-TrainingData/BraTS-GLI-01326-000/BraTS-GLI-01326-000-t1c.nii.gz,../../DataSet/ASNR-MICCAI-BraTS2023-GLI-Challenge-TrainingData/BraTS-GLI-01326-000/BraTS-GLI-01326-000-t2w.nii.gz,../../DataSet/ASNR-MICCAI-BraTS2023-GLI-Challenge-TrainingData/BraTS-GLI-01326-000/BraTS-GLI-01326-000-t2f.nii.gz,../../DataSet/ASNR-MICCAI-BraTS2023-GLI-Challenge-TrainingData/BraTS-GLI-01326-000/BraTS-GLI-01326-000-t1n.nii.gz,../../DataSet/ASNR-MICCAI-BraTS2023-GLI-Challenge-TrainingData/BraTS-GLI-01326-000/BraTS-GLI-01326-000-seg.nii.gz,88,124,76,53,131,79,174,34,118,78,95,84
00210-000,../../DataSet/ASNR-MICCAI-BraTS2023-GLI-Challenge-TrainingData/BraTS-GLI-00210-000/BraTS-GLI-00210-000-t1c.nii.gz,../../DataSet/ASNR-MICCAI-BraTS2023-GLI-Challenge-TrainingData/BraTS-GLI-00210-000/BraTS-GLI-00210-000-t2w.nii.gz,../../DataSet/ASNR-MICCAI-BraTS2023-GLI-Challenge-TrainingData/BraTS-GLI-00210-000/BraTS-GLI-00210-000-t2f.nii.gz,../../DataSet/ASNR-MICCAI-BraTS2023-GLI-Challenge-TrainingData/BraTS-GLI-00210-000/BraTS-GLI-00210-000-t1n.nii.gz,../../DataSet/ASNR-MICCAI-BraTS2023-GLI-Challenge-TrainingData/BraTS-GLI-00210-000/BraTS-GLI-00210-000-seg.nii.gz,99,142,71,76,121,119,185,53,97,45,66,44
01031-000,../../DataSet/ASNR-MICCAI-BraTS2023-GLI-Challenge-TrainingData/BraTS-GLI-01031-000/BraTS-GLI-01031-000-t1c.nii.gz,../../DataSet/ASNR-MICCAI-BraTS2023-GLI-Challenge-TrainingData/BraTS-GLI-01031-000/BraTS-GLI-01031-000-t2w.nii.gz,../../DataSet/ASNR-MICCAI-BraTS2023-GLI-Challenge-TrainingData/BraTS-GLI-01031-000/BraTS-GLI-01031-000-t2f.nii.gz,../../DataSet/ASNR-MICCAI-BraTS2023-GLI-Challenge-TrainingData/BraTS-GLI-01031-000/BraTS-GLI-01031-000-t1n.nii.gz,../../DataSet/ASNR-MICCAI-BraTS2023-GLI-Challenge-TrainingData/BraTS-GLI-01031-000/BraTS-GLI-01031-000-seg.nii.gz,73,138,90,55,99,114,171,71,113,44,57,42
01508-000,../../DataSet/ASNR-MICCAI-BraTS2023-GLI-Challenge-TrainingData/BraTS-GLI-01508-000/BraTS-GLI-01508-000-t1c.nii.gz,../../DataSet/ASNR-MICCAI-BraTS2023-GLI-Challenge-TrainingData/BraTS-GLI-01508-000/BraTS-GLI-01508-000-t2w.nii.gz,../../DataSet/ASNR-MICCAI-BraTS2023-GLI-Challenge-TrainingData/BraTS-GLI-01508-000/BraTS-GLI-01508-000-t2f.nii.gz,../../DataSet/ASNR-MICCAI-BraTS2023-GLI-Challenge-TrainingData/BraTS-GLI-01508-000/BraTS-GLI-01508-000-t1n.nii.gz,../../DataSet/ASNR-MICCAI-BraTS2023-GLI-Challenge-TrainingData/BraTS-GLI-01508-000/BraTS-GLI-01508-000-seg.nii.gz,129,82,105,117,157,46,116,76,133,40,70,57
00729-000,../../DataSet/ASNR-MICCAI-BraTS2023-GLI-Challenge-TrainingData/BraTS-GLI-00729-000/BraTS-GLI-00729-000-t1c.nii.gz,../../DataSet/ASNR-MICCAI-BraTS2023-GLI-Challenge-TrainingData/BraTS-GLI-00729-000/BraTS-GLI-00729-000-t2w.nii.gz,../../DataSet/ASNR-MICCAI-BraTS2023-GLI-Challenge-TrainingData/BraTS-GLI-00729-000/BraTS-GLI-00729-000-t2f.nii.gz,../../DataSet/ASNR-MICCAI-BraTS2023-GLI-Challenge-TrainingData/BraTS-GLI-00729-000/BraTS-GLI-00729-000-t1n.nii.gz,../../DataSet/ASNR-MICCAI-BraTS2023-GLI-Challenge-TrainingData/BraTS-GLI-00729-000/BraTS-GLI-00729-000-seg.nii.gz,151,158,50,125,171,138,202,36,68,46,64,32
00399-000,../../DataSet/ASNR-MICCAI-BraTS2023-GLI-Challenge-TrainingData/BraTS-GLI-00399-000/BraTS-GLI-00399-000-t1c.nii.gz,../../DataSet/ASNR-MICCAI-BraTS2023-GLI-Challenge-TrainingData/BraTS-GLI-00399-000/BraTS-GLI-00399-000-t2w.nii.gz,../../DataSet/ASNR-MICCAI-BraTS2023-GLI-Challenge-TrainingData/BraTS-GLI-00399-000/BraTS-GLI-00399-000-t2f.nii.gz,../../DataSet/ASNR-MICCAI-BraTS2023-GLI-Challenge-TrainingData/BraTS-GLI-00399-000/BraTS-GLI-00399-000-t1n.nii.gz,../../DataSet/ASNR-MICCAI-BraTS2023-GLI-Challenge-TrainingData/BraTS-GLI-00399-000/BraTS-GLI-00399-000-seg.nii.gz,91,150,74,63,121,114,195,50,102,58,81,52
00100-000,../../DataSet/ASNR-MICCAI-BraTS2023-GLI-Challenge-TrainingData/BraTS-GLI-00100-000/BraTS-GLI-00100-000-t1c.nii.gz,../../DataSet/ASNR-MICCAI-BraTS2023-GLI-Challenge-TrainingData/BraTS-GLI-00100-000/BraTS-GLI-00100-000-t2w.nii.gz,../../DataSet/ASNR-MICCAI-BraTS2023-GLI-Challenge-TrainingData/BraTS-GLI-00100-000/BraTS-GLI-00100-000-t2f.nii.gz,../../DataSet/ASNR-MICCAI-BraTS2023-GLI-Challenge-TrainingData/BraTS-GLI-00100-000/BraTS-GLI-00100-000-t1n.nii.gz,../../DataSet/ASNR-MICCAI-BraTS2023-GLI-Challenge-TrainingData/BraTS-GLI-00100-000/BraTS-GLI-00100-000-seg.nii.gz,145,112,96,123,174,72,150,62,129,51,78,67
00725-001,../../DataSet/ASNR-MICCAI-BraTS2023-GLI-Challenge-TrainingData/BraTS-GLI-00725-001/BraTS-GLI-00725-001-t1c.nii.gz,../../DataSet/ASNR-MICCAI-BraTS2023-GLI-Challenge-TrainingData/BraTS-GLI-00725-001/BraTS-GLI-00725-001-t2w.nii.gz,../../DataSet/ASNR-MICCAI-BraTS2023-GLI-Challenge-TrainingData/BraTS-GLI-00725-001/BraTS-GLI-00725-001-t2f.nii.gz,../../DataSet/ASNR-MICCAI-BraTS2023-GLI-Challenge-TrainingData/BraTS-GLI-00725-001/BraTS-GLI-00725-001-t1n.nii.gz,../../DataSet/ASNR-MICCAI-BraTS2023-GLI-Challenge-TrainingData/BraTS-GLI-00725-001/BraTS-GLI-00725-001-seg.nii.gz,122,94,88,76,168,54,144,53,125,92,90,72
01486-000,../../DataSet/ASNR-MICCAI-BraTS2023-GLI-Challenge-TrainingData/BraTS-GLI-01486-000/BraTS-GLI-01486-000-t1c.nii.gz,../../DataSet/ASNR-MICCAI-BraTS2023-GLI-Challenge-TrainingData/BraTS-GLI-01486-000/BraTS-GLI-01486-000-t2w.nii.gz,../../DataSet/ASNR-MICCAI-BraTS2023-GLI-Challenge-TrainingData/BraTS-GLI-01486-000/BraTS-GLI-01486-000-t2f.nii.gz,../../DataSet/ASNR-MICCAI-BraTS2023-GLI-Challenge-TrainingData/BraTS-GLI-01486-000/BraTS-GLI-01486-000-t1n.nii.gz,../../DataSet/ASNR-MICCAI-BraTS2023-GLI-Challenge-TrainingData/BraTS-GLI-01486-000/BraTS-GLI-01486-000-seg.nii.gz,91,137,89,63,130,89,180,49,130,67,91,81
01457-000,../../DataSet/ASNR-MICCAI-BraTS2023-GLI-Challenge-TrainingData/BraTS-GLI-01457-000/BraTS-GLI-01457-000-t1c.nii.gz,../../DataSet/ASNR-MICCAI-BraTS2023-GLI-Challenge-TrainingData/BraTS-GLI-01457-000/BraTS-GLI-01457-000-t2w.nii.gz,../../DataSet/ASNR-MICCAI-BraTS2023-GLI-Challenge-TrainingData/BraTS-GLI-01457-000/BraTS-GLI-01457-000-t2f.nii.gz,../../DataSet/ASNR-MICCAI-BraTS2023-GLI-Challenge-TrainingData/BraTS-GLI-01457-000/BraTS-GLI-01457-000-t1n.nii.gz,../../DataSet/ASNR-MICCAI-BraTS2023-GLI-Challenge-TrainingData/BraTS-GLI-01457-000/BraTS-GLI-01457-000-seg.nii.gz,156,141,63,130,181,109,183,36,93,51,74,57
00053-001,../../DataSet/ASNR-MICCAI-BraTS2023-GLI-Challenge-TrainingData/BraTS-GLI-00053-001/BraTS-GLI-00053-001-t1c.nii.gz,../../DataSet/ASNR-MICCAI-BraTS2023-GLI-Challenge-TrainingData/BraTS-GLI-00053-001/BraTS-GLI-00053-001-t2w.nii.gz,../../DataSet/ASNR-MICCAI-BraTS2023-GLI-Challenge-TrainingData/BraTS-GLI-00053-001/BraTS-GLI-00053-001-t2f.nii.gz,../../DataSet/ASNR-MICCAI-BraTS2023-GLI-Challenge-TrainingData/BraTS-GLI-00053-001/BraTS-GLI-00053-001-t1n.nii.gz,../../DataSet/ASNR-MICCAI-BraTS2023-GLI-Challenge-TrainingData/BraTS-GLI-00053-001/BraTS-GLI-00053-001-seg.nii.gz,137,103,94,97,168,63,144,52,138,71,81,86
00676-000,../../DataSet/ASNR-MICCAI-BraTS2023-GLI-Challenge-TrainingData/BraTS-GLI-00676-000/BraTS-GLI-00676-000-t1c.nii.gz,../../DataSet/ASNR-MICCAI-BraTS2023-GLI-Challenge-TrainingData/BraTS-GLI-00676-000/BraTS-GLI-00676-000-t2w.nii.gz,../../DataSet/ASNR-MICCAI-BraTS2023-GLI-Challenge-TrainingData/BraTS-GLI-00676-000/BraTS-GLI-00676-000-t2f.nii.gz,../../DataSet/ASNR-MICCAI-BraTS2023-GLI-Challenge-TrainingData/BraTS-GLI-00676-000/BraTS-GLI-00676-000-t1n.nii.gz,../../DataSet/ASNR-MICCAI-BraTS2023-GLI-Challenge-TrainingData/BraTS-GLI-00676-000/BraTS-GLI-00676-000-seg.nii.gz,134,128,106,98,178,97,191,47,142,80,94,95
01036-000,../../DataSet/ASNR-MICCAI-BraTS2023-GLI-Challenge-TrainingData/BraTS-GLI-01036-000/BraTS-GLI-01036-000-t1c.nii.gz,../../DataSet/ASNR-MICCAI-BraTS2023-GLI-Challenge-TrainingData/BraTS-GLI-01036-000/BraTS-GLI-01036-000-t2w.nii.gz,../../DataSet/ASNR-MICCAI-BraTS2023-GLI-Challenge-TrainingData/BraTS-GLI-01036-000/BraTS-GLI-01036-000-t2f.nii.gz,../../DataSet/ASNR-MICCAI-BraTS2023-GLI-Challenge-TrainingData/BraTS-GLI-01036-000/BraTS-GLI-01036-000-t1n.nii.gz,../../DataSet/ASNR-MICCAI-BraTS2023-GLI-Challenge-TrainingData/BraTS-GLI-01036-000/BraTS-GLI-01036-000-seg.nii.gz,165,144,88,144,185,124,163,72,109,41,39,37
00089-000,../../DataSet/ASNR-MICCAI-BraTS2023-GLI-Challenge-TrainingData/BraTS-GLI-00089-000/BraTS-GLI-00089-000-t1c.nii.gz,../../DataSet/ASNR-MICCAI-BraTS2023-GLI-Challenge-TrainingData/BraTS-GLI-00089-000/BraTS-GLI-00089-000-t2w.nii.gz,../../DataSet/ASNR-MICCAI-BraTS2023-GLI-Challenge-TrainingData/BraTS-GLI-00089-000/BraTS-GLI-00089-000-t2f.nii.gz,../../DataSet/ASNR-MICCAI-BraTS2023-GLI-Challenge-TrainingData/BraTS-GLI-00089-000/BraTS-GLI-00089-000-t1n.nii.gz,../../DataSet/ASNR-MICCAI-BraTS2023-GLI-Challenge-TrainingData/BraTS-GLI-00089-000/BraTS-GLI-00089-000-seg.nii.gz,149,108,83,109,175,84,132,63,108,66,48,45
00058-000,../../DataSet/ASNR-MICCAI-BraTS2023-GLI-Challenge-TrainingData/BraTS-GLI-00058-000/BraTS-GLI-00058-000-t1c.nii.gz,../../DataSet/ASNR-MICCAI-BraTS2023-GLI-Challenge-TrainingData/BraTS-GLI-00058-000/BraTS-GLI-00058-000-t2w.nii.gz,../../DataSet/ASNR-MICCAI-BraTS2023-GLI-Challenge-TrainingData/BraTS-GLI-00058-000/BraTS-GLI-00058-000-t2f.nii.gz,../../DataSet/ASNR-MICCAI-BraTS2023-GLI-Challenge-TrainingData/BraTS-GLI-00058-000/BraTS-GLI-00058-000-t1n.nii.gz,../../DataSet/ASNR-MICCAI-BraTS2023-GLI-Challenge-TrainingData/BraTS-GLI-00058-000/BraTS-GLI-00058-000-seg.nii.gz,149,167,66,128,176,138,192,52,87,48,54,35
01279-000,../../DataSet/ASNR-MICCAI-BraTS2023-GLI-Challenge-TrainingData/BraTS-GLI-01279-000/BraTS-GLI-01279-000-t1c.nii.gz,../../DataSet/ASNR-MICCAI-BraTS2023-GLI-Challenge-TrainingData/BraTS-GLI-01279-000/BraTS-GLI-01279-000-t2w.nii.gz,../../DataSet/ASNR-MICCAI-BraTS2023-GLI-Challenge-TrainingData/BraTS-GLI-01279-000/BraTS-GLI-01279-000-t2f.nii.gz,../../DataSet/ASNR-MICCAI-BraTS2023-GLI-Challenge-TrainingData/BraTS-GLI-01279-000/BraTS-GLI-01279-000-t1n.nii.gz,../../DataSet/ASNR-MICCAI-BraTS2023-GLI-Challenge-TrainingData/BraTS-GLI-01279-000/BraTS-GLI-01279-000-seg.nii.gz,135,140,114,120,162,106,168,47,137,42,62,90
01112-000,../../DataSet/ASNR-MICCAI-BraTS2023-GLI-Challenge-TrainingData/BraTS-GLI-01112-000/BraTS-GLI-01112-000-t1c.nii.gz,../../DataSet/ASNR-MICCAI-BraTS2023-GLI-Challenge-TrainingData/BraTS-GLI-01112-000/BraTS-GLI-01112-000-t2w.nii.gz,../../DataSet/ASNR-MICCAI-BraTS2023-GLI-Challenge-TrainingData/BraTS-GLI-01112-000/BraTS-GLI-01112-000-t2f.nii.gz,../../DataSet/ASNR-MICCAI-BraTS2023-GLI-Challenge-TrainingData/BraTS-GLI-01112-000/BraTS-GLI-01112-000-t1n.nii.gz,../../DataSet/ASNR-MICCAI-BraTS2023-GLI-Challenge-TrainingData/BraTS-GLI-01112-000/BraTS-GLI-01112-000-seg.nii.gz,105,92,95,75,142,45,137,64,137,67,92,73
01664-000,../../DataSet/ASNR-MICCAI-BraTS2023-GLI-Challenge-TrainingData/BraTS-GLI-01664-000/BraTS-GLI-01664-000-t1c.nii.gz,../../DataSet/ASNR-MICCAI-BraTS2023-GLI-Challenge-TrainingData/BraTS-GLI-01664-000/BraTS-GLI-01664-000-t2w.nii.gz,../../DataSet/ASNR-MICCAI-BraTS2023-GLI-Challenge-TrainingData/BraTS-GLI-01664-000/BraTS-GLI-01664-000-t2f.nii.gz,../../DataSet/ASNR-MICCAI-BraTS2023-GLI-Challenge-TrainingData/BraTS-GLI-01664-000/BraTS-GLI-01664-000-t1n.nii.gz,../../DataSet/ASNR-MICCAI-BraTS2023-GLI-Challenge-TrainingData/BraTS-GLI-01664-000/BraTS-GLI-01664-000-seg.nii.gz,150,160,91,117,185,118,208,55,131,68,90,76
00024-000,../../DataSet/ASNR-MICCAI-BraTS2023-GLI-Challenge-TrainingData/BraTS-GLI-00024-000/BraTS-GLI-00024-000-t1c.nii.gz,../../DataSet/ASNR-MICCAI-BraTS2023-GLI-Challenge-TrainingData/BraTS-GLI-00024-000/BraTS-GLI-00024-000-t2w.nii.gz,../../DataSet/ASNR-MICCAI-BraTS2023-GLI-Challenge-TrainingData/BraTS-GLI-00024-000/BraTS-GLI-00024-000-t2f.nii.gz,../../DataSet/ASNR-MICCAI-BraTS2023-GLI-Challenge-TrainingData/BraTS-GLI-00024-000/BraTS-GLI-00024-000-t1n.nii.gz,../../DataSet/ASNR-MICCAI-BraTS2023-GLI-Challenge-TrainingData/BraTS-GLI-00024-000/BraTS-GLI-00024-000-seg.nii.gz,162,123,54,123,188,85,171,25,108,65,86,83
01205-000,../../DataSet/ASNR-MICCAI-BraTS2023-GLI-Challenge-TrainingData/BraTS-GLI-01205-000/BraTS-GLI-01205-000-t1c.nii.gz,../../DataSet/ASNR-MICCAI-BraTS2023-GLI-Challenge-TrainingData/BraTS-GLI-01205-000/BraTS-GLI-01205-000-t2w.nii.gz,../../DataSet/ASNR-MICCAI-BraTS2023-GLI-Challenge-TrainingData/BraTS-GLI-01205-000/BraTS-GLI-01205-000-t2f.nii.gz,../../DataSet/ASNR-MICCAI-BraTS2023-GLI-Challenge-TrainingData/BraTS-GLI-01205-000/BraTS-GLI-01205-000-t1n.nii.gz,../../DataSet/ASNR-MICCAI-BraTS2023-GLI-Challenge-TrainingData/BraTS-GLI-01205-000/BraTS-GLI-01205-000-seg.nii.gz,151,171,102,118,176,146,194,80,130,58,48,50
01003-000,../../DataSet/ASNR-MICCAI-BraTS2023-GLI-Challenge-TrainingData/BraTS-GLI-01003-000/BraTS-GLI-01003-000-t1c.nii.gz,../../DataSet/ASNR-MICCAI-BraTS2023-GLI-Challenge-TrainingData/BraTS-GLI-01003-000/BraTS-GLI-01003-000-t2w.nii.gz,../../DataSet/ASNR-MICCAI-BraTS2023-GLI-Challenge-TrainingData/BraTS-GLI-01003-000/BraTS-GLI-01003-000-t2f.nii.gz,../../DataSet/ASNR-MICCAI-BraTS2023-GLI-Challenge-TrainingData/BraTS-GLI-01003-000/BraTS-GLI-01003-000-t1n.nii.gz,../../DataSet/ASNR-MICCAI-BraTS2023-GLI-Challenge-TrainingData/BraTS-GLI-01003-000/BraTS-GLI-01003-000-seg.nii.gz,129,136,83,103,160,85,172,44,129,57,87,85
00222-000,../../DataSet/ASNR-MICCAI-BraTS2023-GLI-Challenge-TrainingData/BraTS-GLI-00222-000/BraTS-GLI-00222-000-t1c.nii.gz,../../DataSet/ASNR-MICCAI-BraTS2023-GLI-Challenge-TrainingData/BraTS-GLI-00222-000/BraTS-GLI-00222-000-t2w.nii.gz,../../DataSet/ASNR-MICCAI-BraTS2023-GLI-Challenge-TrainingData/BraTS-GLI-00222-000/BraTS-GLI-00222-000-t2f.nii.gz,../../DataSet/ASNR-MICCAI-BraTS2023-GLI-Challenge-TrainingData/BraTS-GLI-00222-000/BraTS-GLI-00222-000-t1n.nii.gz,../../DataSet/ASNR-MICCAI-BraTS2023-GLI-Challenge-TrainingData/BraTS-GLI-00222-000/BraTS-GLI-00222-000-seg.nii.gz,91,150,111,78,108,134,170,92,134,30,36,42
01314-000,../../DataSet/ASNR-MICCAI-BraTS2023-GLI-Challenge-TrainingData/BraTS-GLI-01314-000/BraTS-GLI-01314-000-t1c.nii.gz,../../DataSet/ASNR-MICCAI-BraTS2023-GLI-Challenge-TrainingData/BraTS-GLI-01314-000/BraTS-GLI-01314-000-t2w.nii.gz,../../DataSet/ASNR-MICCAI-BraTS2023-GLI-Challenge-TrainingData/BraTS-GLI-01314-000/BraTS-GLI-01314-000-t2f.nii.gz,../../DataSet/ASNR-MICCAI-BraTS2023-GLI-Challenge-TrainingData/BraTS-GLI-01314-000/BraTS-GLI-01314-000-t1n.nii.gz,../../DataSet/ASNR-MICCAI-BraTS2023-GLI-Challenge-TrainingData/BraTS-GLI-01314-000/BraTS-GLI-01314-000-seg.nii.gz,135,160,103,119,160,123,197,71,140,41,74,69
00692-000,../../DataSet/ASNR-MICCAI-BraTS2023-GLI-Challenge-TrainingData/BraTS-GLI-00692-000/BraTS-GLI-00692-000-t1c.nii.gz,../../DataSet/ASNR-MICCAI-BraTS2023-GLI-Challenge-TrainingData/BraTS-GLI-00692-000/BraTS-GLI-00692-000-t2w.nii.gz,../../DataSet/ASNR-MICCAI-BraTS2023-GLI-Challenge-TrainingData/BraTS-GLI-00692-000/BraTS-GLI-00692-000-t2f.nii.gz,../../DataSet/ASNR-MICCAI-BraTS2023-GLI-Challenge-TrainingData/BraTS-GLI-00692-000/BraTS-GLI-00692-000-t1n.nii.gz,../../DataSet/ASNR-MICCAI-BraTS2023-GLI-Challenge-TrainingData/BraTS-GLI-00692-000/BraTS-GLI-00692-000-seg.nii.gz,97,124,108,72,121,96,160,81,140,49,64,59
00149-000,../../DataSet/ASNR-MICCAI-BraTS2023-GLI-Challenge-TrainingData/BraTS-GLI-00149-000/BraTS-GLI-00149-000-t1c.nii.gz,../../DataSet/ASNR-MICCAI-BraTS2023-GLI-Challenge-TrainingData/BraTS-GLI-00149-000/BraTS-GLI-00149-000-t2w.nii.gz,../../DataSet/ASNR-MICCAI-BraTS2023-GLI-Challenge-TrainingData/BraTS-GLI-00149-000/BraTS-GLI-00149-000-t2f.nii.gz,../../DataSet/ASNR-MICCAI-BraTS2023-GLI-Challenge-TrainingData/BraTS-GLI-00149-000/BraTS-GLI-00149-000-t1n.nii.gz,../../DataSet/ASNR-MICCAI-BraTS2023-GLI-Challenge-TrainingData/BraTS-GLI-00149-000/BraTS-GLI-00149-000-seg.nii.gz,82,139,90,63,106,98,165,68,112,43,67,44
00470-000,../../DataSet/ASNR-MICCAI-BraTS2023-GLI-Challenge-TrainingData/BraTS-GLI-00470-000/BraTS-GLI-00470-000-t1c.nii.gz,../../DataSet/ASNR-MICCAI-BraTS2023-GLI-Challenge-TrainingData/BraTS-GLI-00470-000/BraTS-GLI-00470-000-t2w.nii.gz,../../DataSet/ASNR-MICCAI-BraTS2023-GLI-Challenge-TrainingData/BraTS-GLI-00470-000/BraTS-GLI-00470-000-t2f.nii.gz,../../DataSet/ASNR-MICCAI-BraTS2023-GLI-Challenge-TrainingData/BraTS-GLI-00470-000/BraTS-GLI-00470-000-t1n.nii.gz,../../DataSet/ASNR-MICCAI-BraTS2023-GLI-Challenge-TrainingData/BraTS-GLI-00470-000/BraTS-GLI-00470-000-seg.nii.gz,153,129,104,122,183,93,165,70,137,61,72,67
00802-000,../../DataSet/ASNR-MICCAI-BraTS2023-GLI-Challenge-TrainingData/BraTS-GLI-00802-000/BraTS-GLI-00802-000-t1c.nii.gz,../../DataSet/ASNR-MICCAI-BraTS2023-GLI-Challenge-TrainingData/BraTS-GLI-00802-000/BraTS-GLI-00802-000-t2w.nii.gz,../../DataSet/ASNR-MICCAI-BraTS2023-GLI-Challenge-TrainingData/BraTS-GLI-00802-000/BraTS-GLI-00802-000-t2f.nii.gz,../../DataSet/ASNR-MICCAI-BraTS2023-GLI-Challenge-TrainingData/BraTS-GLI-00802-000/BraTS-GLI-00802-000-t1n.nii.gz,../../DataSet/ASNR-MICCAI-BraTS2023-GLI-Challenge-TrainingData/BraTS-GLI-00802-000/BraTS-GLI-00802-000-seg.nii.gz,98,126,62,87,113,106,146,49,84,26,40,35
01230-000,../../DataSet/ASNR-MICCAI-BraTS2023-GLI-Challenge-TrainingData/BraTS-GLI-01230-000/BraTS-GLI-01230-000-t1c.nii.gz,../../DataSet/ASNR-MICCAI-BraTS2023-GLI-Challenge-TrainingData/BraTS-GLI-01230-000/BraTS-GLI-01230-000-t2w.nii.gz,../../DataSet/ASNR-MICCAI-BraTS2023-GLI-Challenge-TrainingData/BraTS-GLI-01230-000/BraTS-GLI-01230-000-t2f.nii.gz,../../DataSet/ASNR-MICCAI-BraTS2023-GLI-Challenge-TrainingData/BraTS-GLI-01230-000/BraTS-GLI-01230-000-t1n.nii.gz,../../DataSet/ASNR-MICCAI-BraTS2023-GLI-Challenge-TrainingData/BraTS-GLI-01230-000/BraTS-GLI-01230-000-seg.nii.gz,156,164,51,135,175,133,192,33,75,40,59,42
00011-000,../../DataSet/ASNR-MICCAI-BraTS2023-GLI-Challenge-TrainingData/BraTS-GLI-00011-000/BraTS-GLI-00011-000-t1c.nii.gz,../../DataSet/ASNR-MICCAI-BraTS2023-GLI-Challenge-TrainingData/BraTS-GLI-00011-000/BraTS-GLI-00011-000-t2w.nii.gz,../../DataSet/ASNR-MICCAI-BraTS2023-GLI-Challenge-TrainingData/BraTS-GLI-00011-000/BraTS-GLI-00011-000-t2f.nii.gz,../../DataSet/ASNR-MICCAI-BraTS2023-GLI-Challenge-TrainingData/BraTS-GLI-00011-000/BraTS-GLI-00011-000-t1n.nii.gz,../../DataSet/ASNR-MICCAI-BraTS2023-GLI-Challenge-TrainingData/BraTS-GLI-00011-000/BraTS-GLI-00011-000-seg.nii.gz,79,148,91,56,103,117,184,65,125,47,67,60
00767-000,../../DataSet/ASNR-MICCAI-BraTS2023-GLI-Challenge-TrainingData/BraTS-GLI-00767-000/BraTS-GLI-00767-000-t1c.nii.gz,../../DataSet/ASNR-MICCAI-BraTS2023-GLI-Challenge-TrainingData/BraTS-GLI-00767-000/BraTS-GLI-00767-000-t2w.nii.gz,../../DataSet/ASNR-MICCAI-BraTS2023-GLI-Challenge-TrainingData/BraTS-GLI-00767-000/BraTS-GLI-00767-000-t2f.nii.gz,../../DataSet/ASNR-MICCAI-BraTS2023-GLI-Challenge-TrainingData/BraTS-GLI-00767-000/BraTS-GLI-00767-000-t1n.nii.gz,../../DataSet/ASNR-MICCAI-BraTS2023-GLI-Challenge-TrainingData/BraTS-GLI-00767-000/BraTS-GLI-00767-000-seg.nii.gz,141,154,105,114,172,123,188,69,137,58,65,68
01127-000,../../DataSet/ASNR-MICCAI-BraTS2023-GLI-Challenge-TrainingData/BraTS-GLI-01127-000/BraTS-GLI-01127-000-t1c.nii.gz,../../DataSet/ASNR-MICCAI-BraTS2023-GLI-Challenge-TrainingData/BraTS-GLI-01127-000/BraTS-GLI-01127-000-t2w.nii.gz,../../DataSet/ASNR-MICCAI-BraTS2023-GLI-Challenge-TrainingData/BraTS-GLI-01127-000/BraTS-GLI-01127-000-t2f.nii.gz,../../DataSet/ASNR-MICCAI-BraTS2023-GLI-Challenge-TrainingData/BraTS-GLI-01127-000/BraTS-GLI-01127-000-t1n.nii.gz,../../DataSet/ASNR-MICCAI-BraTS2023-GLI-Challenge-TrainingData/BraTS-GLI-01127-000/BraTS-GLI-01127-000-seg.nii.gz,167,143,62,146,187,106,180,41,94,41,74,53
00306-000,../../DataSet/ASNR-MICCAI-BraTS2023-GLI-Challenge-TrainingData/BraTS-GLI-00306-000/BraTS-GLI-00306-000-t1c.nii.gz,../../DataSet/ASNR-MICCAI-BraTS2023-GLI-Challenge-TrainingData/BraTS-GLI-00306-000/BraTS-GLI-00306-000-t2w.nii.gz,../../DataSet/ASNR-MICCAI-BraTS2023-GLI-Challenge-TrainingData/BraTS-GLI-00306-000/BraTS-GLI-00306-000-t2f.nii.gz,../../DataSet/ASNR-MICCAI-BraTS2023-GLI-Challenge-TrainingData/BraTS-GLI-00306-000/BraTS-GLI-00306-000-t1n.nii.gz,../../DataSet/ASNR-MICCAI-BraTS2023-GLI-Challenge-TrainingData/BraTS-GLI-00306-000/BraTS-GLI-00306-000-seg.nii.gz,158,134,69,133,180,103,165,46,93,47,62,47
00259-000,../../DataSet/ASNR-MICCAI-BraTS2023-GLI-Challenge-TrainingData/BraTS-GLI-00259-000/BraTS-GLI-00259-000-t1c.nii.gz,../../DataSet/ASNR-MICCAI-BraTS2023-GLI-Challenge-TrainingData/BraTS-GLI-00259-000/BraTS-GLI-00259-000-t2w.nii.gz,../../DataSet/ASNR-MICCAI-BraTS2023-GLI-Challenge-TrainingData/BraTS-GLI-00259-000/BraTS-GLI-00259-000-t2f.nii.gz,../../DataSet/ASNR-MICCAI-BraTS2023-GLI-Challenge-TrainingData/BraTS-GLI-00259-000/BraTS-GLI-00259-000-t1n.nii.gz,../../DataSet/ASNR-MICCAI-BraTS2023-GLI-Challenge-TrainingData/BraTS-GLI-00259-000/BraTS-GLI-00259-000-seg.nii.gz,142,166,90,119,172,125,207,54,132,53,82,78
00288-000,../../DataSet/ASNR-MICCAI-BraTS2023-GLI-Challenge-TrainingData/BraTS-GLI-00288-000/BraTS-GLI-00288-000-t1c.nii.gz,../../DataSet/ASNR-MICCAI-BraTS2023-GLI-Challenge-TrainingData/BraTS-GLI-00288-000/BraTS-GLI-00288-000-t2w.nii.gz,../../DataSet/ASNR-MICCAI-BraTS2023-GLI-Challenge-TrainingData/BraTS-GLI-00288-000/BraTS-GLI-00288-000-t2f.nii.gz,../../DataSet/ASNR-MICCAI-BraTS2023-GLI-Challenge-TrainingData/BraTS-GLI-00288-000/BraTS-GLI-00288-000-t1n.nii.gz,../../DataSet/ASNR-MICCAI-BraTS2023-GLI-Challenge-TrainingData/BraTS-GLI-00288-000/BraTS-GLI-00288-000-seg.nii.gz,103,133,116,85,119,113,152,95,138,34,39,43
00805-000,../../DataSet/ASNR-MICCAI-BraTS2023-GLI-Challenge-TrainingData/BraTS-GLI-00805-000/BraTS-GLI-00805-000-t1c.nii.gz,../../DataSet/ASNR-MICCAI-BraTS2023-GLI-Challenge-TrainingData/BraTS-GLI-00805-000/BraTS-GLI-00805-000-t2w.nii.gz,../../DataSet/ASNR-MICCAI-BraTS2023-GLI-Challenge-TrainingData/BraTS-GLI-00805-000/BraTS-GLI-00805-000-t2f.nii.gz,../../DataSet/ASNR-MICCAI-BraTS2023-GLI-Challenge-TrainingData/BraTS-GLI-00805-000/BraTS-GLI-00805-000-t1n.nii.gz,../../DataSet/ASNR-MICCAI-BraTS2023-GLI-Challenge-TrainingData/BraTS-GLI-00805-000/BraTS-GLI-00805-000-seg.nii.gz,107,107,99,79,169,63,145,66,138,90,82,72
00016-000,../../DataSet/ASNR-MICCAI-BraTS2023-GLI-Challenge-TrainingData/BraTS-GLI-00016-000/BraTS-GLI-00016-000-t1c.nii.gz,../../DataSet/ASNR-MICCAI-BraTS2023-GLI-Challenge-TrainingData/BraTS-GLI-00016-000/BraTS-GLI-00016-000-t2w.nii.gz,../../DataSet/ASNR-MICCAI-BraTS2023-GLI-Challenge-TrainingData/BraTS-GLI-00016-000/BraTS-GLI-00016-000-t2f.nii.gz,../../DataSet/ASNR-MICCAI-BraTS2023-GLI-Challenge-TrainingData/BraTS-GLI-00016-000/BraTS-GLI-00016-000-t1n.nii.gz,../../DataSet/ASNR-MICCAI-BraTS2023-GLI-Challenge-TrainingData/BraTS-GLI-00016-000/BraTS-GLI-00016-000-seg.nii.gz,154,167,74,126,184,129,199,47,107,58,70,60
01120-000,../../DataSet/ASNR-MICCAI-BraTS2023-GLI-Challenge-TrainingData/BraTS-GLI-01120-000/BraTS-GLI-01120-000-t1c.nii.gz,../../DataSet/ASNR-MICCAI-BraTS2023-GLI-Challenge-TrainingData/BraTS-GLI-01120-000/BraTS-GLI-01120-000-t2w.nii.gz,../../DataSet/ASNR-MICCAI-BraTS2023-GLI-Challenge-TrainingData/BraTS-GLI-01120-000/BraTS-GLI-01120-000-t2f.nii.gz,../../DataSet/ASNR-MICCAI-BraTS2023-GLI-Challenge-TrainingData/BraTS-GLI-01120-000/BraTS-GLI-01120-000-t1n.nii.gz,../../DataSet/ASNR-MICCAI-BraTS2023-GLI-Challenge-TrainingData/BraTS-GLI-01120-000/BraTS-GLI-01120-000-seg.nii.gz,144,106,77,115,176,69,160,39,133,61,91,94
00301-000,../../DataSet/ASNR-MICCAI-BraTS2023-GLI-Challenge-TrainingData/BraTS-GLI-00301-000/BraTS-GLI-00301-000-t1c.nii.gz,../../DataSet/ASNR-MICCAI-BraTS2023-GLI-Challenge-TrainingData/BraTS-GLI-00301-000/BraTS-GLI-00301-000-t2w.nii.gz,../../DataSet/ASNR-MICCAI-BraTS2023-GLI-Challenge-TrainingData/BraTS-GLI-00301-000/BraTS-GLI-00301-000-t2f.nii.gz,../../DataSet/ASNR-MICCAI-BraTS2023-GLI-Challenge-TrainingData/BraTS-GLI-00301-000/BraTS-GLI-00301-000-t1n.nii.gz,../../DataSet/ASNR-MICCAI-BraTS2023-GLI-Challenge-TrainingData/BraTS-GLI-00301-000/BraTS-GLI-00301-000-seg.nii.gz,142,142,76,109,172,111,175,49,107,63,64,58
01004-000,../../DataSet/ASNR-MICCAI-BraTS2023-GLI-Challenge-TrainingData/BraTS-GLI-01004-000/BraTS-GLI-01004-000-t1c.nii.gz,../../DataSet/ASNR-MICCAI-BraTS2023-GLI-Challenge-TrainingData/BraTS-GLI-01004-000/BraTS-GLI-01004-000-t2w.nii.gz,../../DataSet/ASNR-MICCAI-BraTS2023-GLI-Challenge-TrainingData/BraTS-GLI-01004-000/BraTS-GLI-01004-000-t2f.nii.gz,../../DataSet/ASNR-MICCAI-BraTS2023-GLI-Challenge-TrainingData/BraTS-GLI-01004-000/BraTS-GLI-01004-000-t1n.nii.gz,../../DataSet/ASNR-MICCAI-BraTS2023-GLI-Challenge-TrainingData/BraTS-GLI-01004-000/BraTS-GLI-01004-000-seg.nii.gz,153,121,91,130,182,87,172,60,119,52,85,59
00061-001,../../DataSet/ASNR-MICCAI-BraTS2023-GLI-Challenge-TrainingData/BraTS-GLI-00061-001/BraTS-GLI-00061-001-t1c.nii.gz,../../DataSet/ASNR-MICCAI-BraTS2023-GLI-Challenge-TrainingData/BraTS-GLI-00061-001/BraTS-GLI-00061-001-t2w.nii.gz,../../DataSet/ASNR-MICCAI-BraTS2023-GLI-Challenge-TrainingData/BraTS-GLI-00061-001/BraTS-GLI-00061-001-t2f.nii.gz,../../DataSet/ASNR-MICCAI-BraTS2023-GLI-Challenge-TrainingData/BraTS-GLI-00061-001/BraTS-GLI-00061-001-t1n.nii.gz,../../DataSet/ASNR-MICCAI-BraTS2023-GLI-Challenge-TrainingData/BraTS-GLI-00061-001/BraTS-GLI-00061-001-seg.nii.gz,145,128,52,126,164,93,167,28,79,38,74,51
00582-000,../../DataSet/ASNR-MICCAI-BraTS2023-GLI-Challenge-TrainingData/BraTS-GLI-00582-000/BraTS-GLI-00582-000-t1c.nii.gz,../../DataSet/ASNR-MICCAI-BraTS2023-GLI-Challenge-TrainingData/BraTS-GLI-00582-000/BraTS-GLI-00582-000-t2w.nii.gz,../../DataSet/ASNR-MICCAI-BraTS2023-GLI-Challenge-TrainingData/BraTS-GLI-00582-000/BraTS-GLI-00582-000-t2f.nii.gz,../../DataSet/ASNR-MICCAI-BraTS2023-GLI-Challenge-TrainingData/BraTS-GLI-00582-000/BraTS-GLI-00582-000-t1n.nii.gz,../../DataSet/ASNR-MICCAI-BraTS2023-GLI-Challenge-TrainingData/BraTS-GLI-00582-000/BraTS-GLI-00582-000-seg.nii.gz,85,176,98,64,106,151,205,74,130,42,54,56
01465-000,../../DataSet/ASNR-MICCAI-BraTS2023-GLI-Challenge-TrainingData/BraTS-GLI-01465-000/BraTS-GLI-01465-000-t1c.nii.gz,../../DataSet/ASNR-MICCAI-BraTS2023-GLI-Challenge-TrainingData/BraTS-GLI-01465-000/BraTS-GLI-01465-000-t2w.nii.gz,../../DataSet/ASNR-MICCAI-BraTS2023-GLI-Challenge-TrainingData/BraTS-GLI-01465-000/BraTS-GLI-01465-000-t2f.nii.gz,../../DataSet/ASNR-MICCAI-BraTS2023-GLI-Challenge-TrainingData/BraTS-GLI-01465-000/BraTS-GLI-01465-000-t1n.nii.gz,../../DataSet/ASNR-MICCAI-BraTS2023-GLI-Challenge-TrainingData/BraTS-GLI-01465-000/BraTS-GLI-01465-000-seg.nii.gz,103,87,93,66,138,42,132,55,136,72,90,81
01313-000,../../DataSet/ASNR-MICCAI-BraTS2023-GLI-Challenge-TrainingData/BraTS-GLI-01313-000/BraTS-GLI-01313-000-t1c.nii.gz,../../DataSet/ASNR-MICCAI-BraTS2023-GLI-Challenge-TrainingData/BraTS-GLI-01313-000/BraTS-GLI-01313-000-t2w.nii.gz,../../DataSet/ASNR-MICCAI-BraTS2023-GLI-Challenge-TrainingData/BraTS-GLI-01313-000/BraTS-GLI-01313-000-t2f.nii.gz,../../DataSet/ASNR-MICCAI-BraTS2023-GLI-Challenge-TrainingData/BraTS-GLI-01313-000/BraTS-GLI-01313-000-t1n.nii.gz,../../DataSet/ASNR-MICCAI-BraTS2023-GLI-Challenge-TrainingData/BraTS-GLI-01313-000/BraTS-GLI-01313-000-seg.nii.gz,150,160,86,123,183,117,209,49,127,60,92,78
00558-001,../../DataSet/ASNR-MICCAI-BraTS2023-GLI-Challenge-TrainingData/BraTS-GLI-00558-001/BraTS-GLI-00558-001-t1c.nii.gz,../../DataSet/ASNR-MICCAI-BraTS2023-GLI-Challenge-TrainingData/BraTS-GLI-00558-001/BraTS-GLI-00558-001-t2w.nii.gz,../../DataSet/ASNR-MICCAI-BraTS2023-GLI-Challenge-TrainingData/BraTS-GLI-00558-001/BraTS-GLI-00558-001-t2f.nii.gz,../../DataSet/ASNR-MICCAI-BraTS2023-GLI-Challenge-TrainingData/BraTS-GLI-00558-001/BraTS-GLI-00558-001-t1n.nii.gz,../../DataSet/ASNR-MICCAI-BraTS2023-GLI-Challenge-TrainingData/BraTS-GLI-00558-001/BraTS-GLI-00558-001-seg.nii.gz,103,92,90,64,143,42,135,54,135,79,93,81
00636-000,../../DataSet/ASNR-MICCAI-BraTS2023-GLI-Challenge-TrainingData/BraTS-GLI-00636-000/BraTS-GLI-00636-000-t1c.nii.gz,../../DataSet/ASNR-MICCAI-BraTS2023-GLI-Challenge-TrainingData/BraTS-GLI-00636-000/BraTS-GLI-00636-000-t2w.nii.gz,../../DataSet/ASNR-MICCAI-BraTS2023-GLI-Challenge-TrainingData/BraTS-GLI-00636-000/BraTS-GLI-00636-000-t2f.nii.gz,../../DataSet/ASNR-MICCAI-BraTS2023-GLI-Challenge-TrainingData/BraTS-GLI-00636-000/BraTS-GLI-00636-000-t1n.nii.gz,../../DataSet/ASNR-MICCAI-BraTS2023-GLI-Challenge-TrainingData/BraTS-GLI-00636-000/BraTS-GLI-00636-000-seg.nii.gz,165,112,91,136,184,86,174,70,130,48,88,60
01076-000,../../DataSet/ASNR-MICCAI-BraTS2023-GLI-Challenge-TrainingData/BraTS-GLI-01076-000/BraTS-GLI-01076-000-t1c.nii.gz,../../DataSet/ASNR-MICCAI-BraTS2023-GLI-Challenge-TrainingData/BraTS-GLI-01076-000/BraTS-GLI-01076-000-t2w.nii.gz,../../DataSet/ASNR-MICCAI-BraTS2023-GLI-Challenge-TrainingData/BraTS-GLI-01076-000/BraTS-GLI-01076-000-t2f.nii.gz,../../DataSet/ASNR-MICCAI-BraTS2023-GLI-Challenge-TrainingData/BraTS-GLI-01076-000/BraTS-GLI-01076-000-t1n.nii.gz,../../DataSet/ASNR-MICCAI-BraTS2023-GLI-Challenge-TrainingData/BraTS-GLI-01076-000/BraTS-GLI-01076-000-seg.nii.gz,154,154,88,130,181,117,197,56,123,51,80,67
01417-000,../../DataSet/ASNR-MICCAI-BraTS2023-GLI-Challenge-TrainingData/BraTS-GLI-01417-000/BraTS-GLI-01417-000-t1c.nii.gz,../../DataSet/ASNR-MICCAI-BraTS2023-GLI-Challenge-TrainingData/BraTS-GLI-01417-000/BraTS-GLI-01417-000-t2w.nii.gz,../../DataSet/ASNR-MICCAI-BraTS2023-GLI-Challenge-TrainingData/BraTS-GLI-01417-000/BraTS-GLI-01417-000-t2f.nii.gz,../../DataSet/ASNR-MICCAI-BraTS2023-GLI-Challenge-TrainingData/BraTS-GLI-01417-000/BraTS-GLI-01417-000-t1n.nii.gz,../../DataSet/ASNR-MICCAI-BraTS2023-GLI-Challenge-TrainingData/BraTS-GLI-01417-000/BraTS-GLI-01417-000-seg.nii.gz,108,130,100,81,143,81,176,70,127,62,95,57
01361-000,../../DataSet/ASNR-MICCAI-BraTS2023-GLI-Challenge-TrainingData/BraTS-GLI-01361-000/BraTS-GLI-01361-000-t1c.nii.gz,../../DataSet/ASNR-MICCAI-BraTS2023-GLI-Challenge-TrainingData/BraTS-GLI-01361-000/BraTS-GLI-01361-000-t2w.nii.gz,../../DataSet/ASNR-MICCAI-BraTS2023-GLI-Challenge-TrainingData/BraTS-GLI-01361-000/BraTS-GLI-01361-000-t2f.nii.gz,../../DataSet/ASNR-MICCAI-BraTS2023-GLI-Challenge-TrainingData/BraTS-GLI-01361-000/BraTS-GLI-01361-000-t1n.nii.gz,../../DataSet/ASNR-MICCAI-BraTS2023-GLI-Challenge-TrainingData/BraTS-GLI-01361-000/BraTS-GLI-01361-000-seg.nii.gz,153,164,63,121,181,112,208,36,98,60,96,62
00140-000,../../DataSet/ASNR-MICCAI-BraTS2023-GLI-Challenge-TrainingData/BraTS-GLI-00140-000/BraTS-GLI-00140-000-t1c.nii.gz,../../DataSet/ASNR-MICCAI-BraTS2023-GLI-Challenge-TrainingData/BraTS-GLI-00140-000/BraTS-GLI-00140-000-t2w.nii.gz,../../DataSet/ASNR-MICCAI-BraTS2023-GLI-Challenge-TrainingData/BraTS-GLI-00140-000/BraTS-GLI-00140-000-t2f.nii.gz,../../DataSet/ASNR-MICCAI-BraTS2023-GLI-Challenge-TrainingData/BraTS-GLI-00140-000/BraTS-GLI-00140-000-t1n.nii.gz,../../DataSet/ASNR-MICCAI-BraTS2023-GLI-Challenge-TrainingData/BraTS-GLI-00140-000/BraTS-GLI-00140-000-seg.nii.gz,163,172,86,147,179,156,193,63,112,32,37,49
00479-000,../../DataSet/ASNR-MICCAI-BraTS2023-GLI-Challenge-TrainingData/BraTS-GLI-00479-000/BraTS-GLI-00479-000-t1c.nii.gz,../../DataSet/ASNR-MICCAI-BraTS2023-GLI-Challenge-TrainingData/BraTS-GLI-00479-000/BraTS-GLI-00479-000-t2w.nii.gz,../../DataSet/ASNR-MICCAI-BraTS2023-GLI-Challenge-TrainingData/BraTS-GLI-00479-000/BraTS-GLI-00479-000-t2f.nii.gz,../../DataSet/ASNR-MICCAI-BraTS2023-GLI-Challenge-TrainingData/BraTS-GLI-00479-000/BraTS-GLI-00479-000-t1n.nii.gz,../../DataSet/ASNR-MICCAI-BraTS2023-GLI-Challenge-TrainingData/BraTS-GLI-00479-000/BraTS-GLI-00479-000-seg.nii.gz,88,120,88,65,110,84,149,70,112,45,65,42
01239-000,../../DataSet/ASNR-MICCAI-BraTS2023-GLI-Challenge-TrainingData/BraTS-GLI-01239-000/BraTS-GLI-01239-000-t1c.nii.gz,../../DataSet/ASNR-MICCAI-BraTS2023-GLI-Challenge-TrainingData/BraTS-GLI-01239-000/BraTS-GLI-01239-000-t2w.nii.gz,../../DataSet/ASNR-MICCAI-BraTS2023-GLI-Challenge-TrainingData/BraTS-GLI-01239-000/BraTS-GLI-01239-000-t2f.nii.gz,../../DataSet/ASNR-MICCAI-BraTS2023-GLI-Challenge-TrainingData/BraTS-GLI-01239-000/BraTS-GLI-01239-000-t1n.nii.gz,../../DataSet/ASNR-MICCAI-BraTS2023-GLI-Challenge-TrainingData/BraTS-GLI-01239-000/BraTS-GLI-01239-000-seg.nii.gz,150,151,85,122,178,123,176,59,110,56,53,51
00018-000,../../DataSet/ASNR-MICCAI-BraTS2023-GLI-Challenge-TrainingData/BraTS-GLI-00018-000/BraTS-GLI-00018-000-t1c.nii.gz,../../DataSet/ASNR-MICCAI-BraTS2023-GLI-Challenge-TrainingData/BraTS-GLI-00018-000/BraTS-GLI-00018-000-t2w.nii.gz,../../DataSet/ASNR-MICCAI-BraTS2023-GLI-Challenge-TrainingData/BraTS-GLI-00018-000/BraTS-GLI-00018-000-t2f.nii.gz,../../DataSet/ASNR-MICCAI-BraTS2023-GLI-Challenge-TrainingData/BraTS-GLI-00018-000/BraTS-GLI-00018-000-t1n.nii.gz,../../DataSet/ASNR-MICCAI-BraTS2023-GLI-Challenge-TrainingData/BraTS-GLI-00018-000/BraTS-GLI-00018-000-seg.nii.gz,146,135,96,119,176,91,180,65,134,57,89,69
01183-000,../../DataSet/ASNR-MICCAI-BraTS2023-GLI-Challenge-TrainingData/BraTS-GLI-01183-000/BraTS-GLI-01183-000-t1c.nii.gz,../../DataSet/ASNR-MICCAI-BraTS2023-GLI-Challenge-TrainingData/BraTS-GLI-01183-000/BraTS-GLI-01183-000-t2w.nii.gz,../../DataSet/ASNR-MICCAI-BraTS2023-GLI-Challenge-TrainingData/BraTS-GLI-01183-000/BraTS-GLI-01183-000-t2f.nii.gz,../../DataSet/ASNR-MICCAI-BraTS2023-GLI-Challenge-TrainingData/BraTS-GLI-01183-000/BraTS-GLI-01183-000-t1n.nii.gz,../../DataSet/ASNR-MICCAI-BraTS2023-GLI-Challenge-TrainingData/BraTS-GLI-01183-000/BraTS-GLI-01183-000-seg.nii.gz,106,77,91,72,140,41,116,62,131,68,75,69
00641-001,../../DataSet/ASNR-MICCAI-BraTS2023-GLI-Challenge-TrainingData/BraTS-GLI-00641-001/BraTS-GLI-00641-001-t1c.nii.gz,../../DataSet/ASNR-MICCAI-BraTS2023-GLI-Challenge-TrainingData/BraTS-GLI-00641-001/BraTS-GLI-00641-001-t2w.nii.gz,../../DataSet/ASNR-MICCAI-BraTS2023-GLI-Challenge-TrainingData/BraTS-GLI-00641-001/BraTS-GLI-00641-001-t2f.nii.gz,../../DataSet/ASNR-MICCAI-BraTS2023-GLI-Challenge-TrainingData/BraTS-GLI-00641-001/BraTS-GLI-00641-001-t1n.nii.gz,../../DataSet/ASNR-MICCAI-BraTS2023-GLI-Challenge-TrainingData/BraTS-GLI-00641-001/BraTS-GLI-00641-001-seg.nii.gz,78,143,88,60,102,118,178,70,108,42,60,38
01152-000,../../DataSet/ASNR-MICCAI-BraTS2023-GLI-Challenge-TrainingData/BraTS-GLI-01152-000/BraTS-GLI-01152-000-t1c.nii.gz,../../DataSet/ASNR-MICCAI-BraTS2023-GLI-Challenge-TrainingData/BraTS-GLI-01152-000/BraTS-GLI-01152-000-t2w.nii.gz,../../DataSet/ASNR-MICCAI-BraTS2023-GLI-Challenge-TrainingData/BraTS-GLI-01152-000/BraTS-GLI-01152-000-t2f.nii.gz,../../DataSet/ASNR-MICCAI-BraTS2023-GLI-Challenge-TrainingData/BraTS-GLI-01152-000/BraTS-GLI-01152-000-t1n.nii.gz,../../DataSet/ASNR-MICCAI-BraTS2023-GLI-Challenge-TrainingData/BraTS-GLI-01152-000/BraTS-GLI-01152-000-seg.nii.gz,80,93,100,64,98,80,108,83,118,34,28,35
01294-000,../../DataSet/ASNR-MICCAI-BraTS2023-GLI-Challenge-TrainingData/BraTS-GLI-01294-000/BraTS-GLI-01294-000-t1c.nii.gz,../../DataSet/ASNR-MICCAI-BraTS2023-GLI-Challenge-TrainingData/BraTS-GLI-01294-000/BraTS-GLI-01294-000-t2w.nii.gz,../../DataSet/ASNR-MICCAI-BraTS2023-GLI-Challenge-TrainingData/BraTS-GLI-01294-000/BraTS-GLI-01294-000-t2f.nii.gz,../../DataSet/ASNR-MICCAI-BraTS2023-GLI-Challenge-TrainingData/BraTS-GLI-01294-000/BraTS-GLI-01294-000-t1n.nii.gz,../../DataSet/ASNR-MICCAI-BraTS2023-GLI-Challenge-TrainingData/BraTS-GLI-01294-000/BraTS-GLI-01294-000-seg.nii.gz,149,121,86,127,180,71,167,52,116,53,96,64
00373-000,../../DataSet/ASNR-MICCAI-BraTS2023-GLI-Challenge-TrainingData/BraTS-GLI-00373-000/BraTS-GLI-00373-000-t1c.nii.gz,../../DataSet/ASNR-MICCAI-BraTS2023-GLI-Challenge-TrainingData/BraTS-GLI-00373-000/BraTS-GLI-00373-000-t2w.nii.gz,../../DataSet/ASNR-MICCAI-BraTS2023-GLI-Challenge-TrainingData/BraTS-GLI-00373-000/BraTS-GLI-00373-000-t2f.nii.gz,../../DataSet/ASNR-MICCAI-BraTS2023-GLI-Challenge-TrainingData/BraTS-GLI-00373-000/BraTS-GLI-00373-000-t1n.nii.gz,../../DataSet/ASNR-MICCAI-BraTS2023-GLI-Challenge-TrainingData/BraTS-GLI-00373-000/BraTS-GLI-00373-000-seg.nii.gz,156,154,50,90,174,93,182,37,69,84,89,32
01242-000,../../DataSet/ASNR-MICCAI-BraTS2023-GLI-Challenge-TrainingData/BraTS-GLI-01242-000/BraTS-GLI-01242-000-t1c.nii.gz,../../DataSet/ASNR-MICCAI-BraTS2023-GLI-Challenge-TrainingData/BraTS-GLI-01242-000/BraTS-GLI-01242-000-t2w.nii.gz,../../DataSet/ASNR-MICCAI-BraTS2023-GLI-Challenge-TrainingData/BraTS-GLI-01242-000/BraTS-GLI-01242-000-t2f.nii.gz,../../DataSet/ASNR-MICCAI-BraTS2023-GLI-Challenge-TrainingData/BraTS-GLI-01242-000/BraTS-GLI-01242-000-t1n.nii.gz,../../DataSet/ASNR-MICCAI-BraTS2023-GLI-Challenge-TrainingData/BraTS-GLI-01242-000/BraTS-GLI-01242-000-seg.nii.gz,83,148,72,58,112,98,191,35,111,54,93,76
00063-000,../../DataSet/ASNR-MICCAI-BraTS2023-GLI-Challenge-TrainingData/BraTS-GLI-00063-000/BraTS-GLI-00063-000-t1c.nii.gz,../../DataSet/ASNR-MICCAI-BraTS2023-GLI-Challenge-TrainingData/BraTS-GLI-00063-000/BraTS-GLI-00063-000-t2w.nii.gz,../../DataSet/ASNR-MICCAI-BraTS2023-GLI-Challenge-TrainingData/BraTS-GLI-00063-000/BraTS-GLI-00063-000-t2f.nii.gz,../../DataSet/ASNR-MICCAI-BraTS2023-GLI-Challenge-TrainingData/BraTS-GLI-00063-000/BraTS-GLI-00063-000-t1n.nii.gz,../../DataSet/ASNR-MICCAI-BraTS2023-GLI-Challenge-TrainingData/BraTS-GLI-00063-000/BraTS-GLI-00063-000-seg.nii.gz,101,141,120,79,117,123,161,96,141,38,38,45
00646-001,../../DataSet/ASNR-MICCAI-BraTS2023-GLI-Challenge-TrainingData/BraTS-GLI-00646-001/BraTS-GLI-00646-001-t1c.nii.gz,../../DataSet/ASNR-MICCAI-BraTS2023-GLI-Challenge-TrainingData/BraTS-GLI-00646-001/BraTS-GLI-00646-001-t2w.nii.gz,../../DataSet/ASNR-MICCAI-BraTS2023-GLI-Challenge-TrainingData/BraTS-GLI-00646-001/BraTS-GLI-00646-001-t2f.nii.gz,../../DataSet/ASNR-MICCAI-BraTS2023-GLI-Challenge-TrainingData/BraTS-GLI-00646-001/BraTS-GLI-00646-001-t1n.nii.gz,../../DataSet/ASNR-MICCAI-BraTS2023-GLI-Challenge-TrainingData/BraTS-GLI-00646-001/BraTS-GLI-00646-001-seg.nii.gz,96,96,93,62,130,49,142,57,136,68,93,79
01184-000,../../DataSet/ASNR-MICCAI-BraTS2023-GLI-Challenge-TrainingData/BraTS-GLI-01184-000/BraTS-GLI-01184-000-t1c.nii.gz,../../DataSet/ASNR-MICCAI-BraTS2023-GLI-Challenge-TrainingData/BraTS-GLI-01184-000/BraTS-GLI-01184-000-t2w.nii.gz,../../DataSet/ASNR-MICCAI-BraTS2023-GLI-Challenge-TrainingData/BraTS-GLI-01184-000/BraTS-GLI-01184-000-t2f.nii.gz,../../DataSet/ASNR-MICCAI-BraTS2023-GLI-Challenge-TrainingData/BraTS-GLI-01184-000/BraTS-GLI-01184-000-t1n.nii.gz,../../DataSet/ASNR-MICCAI-BraTS2023-GLI-Challenge-TrainingData/BraTS-GLI-01184-000/BraTS-GLI-01184-000-seg.nii.gz,90,111,58,65,114,87,138,37,84,49,51,47
00715-000,../../DataSet/ASNR-MICCAI-BraTS2023-GLI-Challenge-TrainingData/BraTS-GLI-00715-000/BraTS-GLI-00715-000-t1c.nii.gz,../../DataSet/ASNR-MICCAI-BraTS2023-GLI-Challenge-TrainingData/BraTS-GLI-00715-000/BraTS-GLI-00715-000-t2w.nii.gz,../../DataSet/ASNR-MICCAI-BraTS2023-GLI-Challenge-TrainingData/BraTS-GLI-00715-000/BraTS-GLI-00715-000-t2f.nii.gz,../../DataSet/ASNR-MICCAI-BraTS2023-GLI-Challenge-TrainingData/BraTS-GLI-00715-000/BraTS-GLI-00715-000-t1n.nii.gz,../../DataSet/ASNR-MICCAI-BraTS2023-GLI-Challenge-TrainingData/BraTS-GLI-00715-000/BraTS-GLI-00715-000-seg.nii.gz,119,137,107,100,144,103,172,85,136,44,69,51
01534-000,../../DataSet/ASNR-MICCAI-BraTS2023-GLI-Challenge-TrainingData/BraTS-GLI-01534-000/BraTS-GLI-01534-000-t1c.nii.gz,../../DataSet/ASNR-MICCAI-BraTS2023-GLI-Challenge-TrainingData/BraTS-GLI-01534-000/BraTS-GLI-01534-000-t2w.nii.gz,../../DataSet/ASNR-MICCAI-BraTS2023-GLI-Challenge-TrainingData/BraTS-GLI-01534-000/BraTS-GLI-01534-000-t2f.nii.gz,../../DataSet/ASNR-MICCAI-BraTS2023-GLI-Challenge-TrainingData/BraTS-GLI-01534-000/BraTS-GLI-01534-000-t1n.nii.gz,../../DataSet/ASNR-MICCAI-BraTS2023-GLI-Challenge-TrainingData/BraTS-GLI-01534-000/BraTS-GLI-01534-000-seg.nii.gz,89,144,61,63,122,104,192,33,97,59,88,64
00196-000,../../DataSet/ASNR-MICCAI-BraTS2023-GLI-Challenge-TrainingData/BraTS-GLI-00196-000/BraTS-GLI-00196-000-t1c.nii.gz,../../DataSet/ASNR-MICCAI-BraTS2023-GLI-Challenge-TrainingData/BraTS-GLI-00196-000/BraTS-GLI-00196-000-t2w.nii.gz,../../DataSet/ASNR-MICCAI-BraTS2023-GLI-Challenge-TrainingData/BraTS-GLI-00196-000/BraTS-GLI-00196-000-t2f.nii.gz,../../DataSet/ASNR-MICCAI-BraTS2023-GLI-Challenge-TrainingData/BraTS-GLI-00196-000/BraTS-GLI-00196-000-t1n.nii.gz,../../DataSet/ASNR-MICCAI-BraTS2023-GLI-Challenge-TrainingData/BraTS-GLI-00196-000/BraTS-GLI-00196-000-seg.nii.gz,107,119,107,74,144,83,160,73,140,70,77,67
00014-001,../../DataSet/ASNR-MICCAI-BraTS2023-GLI-Challenge-TrainingData/BraTS-GLI-00014-001/BraTS-GLI-00014-001-t1c.nii.gz,../../DataSet/ASNR-MICCAI-BraTS2023-GLI-Challenge-TrainingData/BraTS-GLI-00014-001/BraTS-GLI-00014-001-t2w.nii.gz,../../DataSet/ASNR-MICCAI-BraTS2023-GLI-Challenge-TrainingData/BraTS-GLI-00014-001/BraTS-GLI-00014-001-t2f.nii.gz,../../DataSet/ASNR-MICCAI-BraTS2023-GLI-Challenge-TrainingData/BraTS-GLI-00014-001/BraTS-GLI-00014-001-t1n.nii.gz,../../DataSet/ASNR-MICCAI-BraTS2023-GLI-Challenge-TrainingData/BraTS-GLI-00014-001/BraTS-GLI-00014-001-seg.nii.gz,149,122,47,128,177,89,157,27,66,49,68,39
00631-000,../../DataSet/ASNR-MICCAI-BraTS2023-GLI-Challenge-TrainingData/BraTS-GLI-00631-000/BraTS-GLI-00631-000-t1c.nii.gz,../../DataSet/ASNR-MICCAI-BraTS2023-GLI-Challenge-TrainingData/BraTS-GLI-00631-000/BraTS-GLI-00631-000-t2w.nii.gz,../../DataSet/ASNR-MICCAI-BraTS2023-GLI-Challenge-TrainingData/BraTS-GLI-00631-000/BraTS-GLI-00631-000-t2f.nii.gz,../../DataSet/ASNR-MICCAI-BraTS2023-GLI-Challenge-TrainingData/BraTS-GLI-00631-000/BraTS-GLI-00631-000-t1n.nii.gz,../../DataSet/ASNR-MICCAI-BraTS2023-GLI-Challenge-TrainingData/BraTS-GLI-00631-000/BraTS-GLI-00631-000-seg.nii.gz,138,89,98,114,170,42,136,68,140,56,94,72
00250-000,../../DataSet/ASNR-MICCAI-BraTS2023-GLI-Challenge-TrainingData/BraTS-GLI-00250-000/BraTS-GLI-00250-000-t1c.nii.gz,../../DataSet/ASNR-MICCAI-BraTS2023-GLI-Challenge-TrainingData/BraTS-GLI-00250-000/BraTS-GLI-00250-000-t2w.nii.gz,../../DataSet/ASNR-MICCAI-BraTS2023-GLI-Challenge-TrainingData/BraTS-GLI-00250-000/BraTS-GLI-00250-000-t2f.nii.gz,../../DataSet/ASNR-MICCAI-BraTS2023-GLI-Challenge-TrainingData/BraTS-GLI-00250-000/BraTS-GLI-00250-000-t1n.nii.gz,../../DataSet/ASNR-MICCAI-BraTS2023-GLI-Challenge-TrainingData/BraTS-GLI-00250-000/BraTS-GLI-00250-000-seg.nii.gz,96,136,99,62,155,90,178,62,132,93,88,70
00281-000,../../DataSet/ASNR-MICCAI-BraTS2023-GLI-Challenge-TrainingData/BraTS-GLI-00281-000/BraTS-GLI-00281-000-t1c.nii.gz,../../DataSet/ASNR-MICCAI-BraTS2023-GLI-Challenge-TrainingData/BraTS-GLI-00281-000/BraTS-GLI-00281-000-t2w.nii.gz,../../DataSet/ASNR-MICCAI-BraTS2023-GLI-Challenge-TrainingData/BraTS-GLI-00281-000/BraTS-GLI-00281-000-t2f.nii.gz,../../DataSet/ASNR-MICCAI-BraTS2023-GLI-Challenge-TrainingData/BraTS-GLI-00281-000/BraTS-GLI-00281-000-t1n.nii.gz,../../DataSet/ASNR-MICCAI-BraTS2023-GLI-Challenge-TrainingData/BraTS-GLI-00281-000/BraTS-GLI-00281-000-seg.nii.gz,101,83,90,70,128,49,116,53,134,58,67,81
00147-000,../../DataSet/ASNR-MICCAI-BraTS2023-GLI-Challenge-TrainingData/BraTS-GLI-00147-000/BraTS-GLI-00147-000-t1c.nii.gz,../../DataSet/ASNR-MICCAI-BraTS2023-GLI-Challenge-TrainingData/BraTS-GLI-00147-000/BraTS-GLI-00147-000-t2w.nii.gz,../../DataSet/ASNR-MICCAI-BraTS2023-GLI-Challenge-TrainingData/BraTS-GLI-00147-000/BraTS-GLI-00147-000-t2f.nii.gz,../../DataSet/ASNR-MICCAI-BraTS2023-GLI-Challenge-TrainingData/BraTS-GLI-00147-000/BraTS-GLI-00147-000-t1n.nii.gz,../../DataSet/ASNR-MICCAI-BraTS2023-GLI-Challenge-TrainingData/BraTS-GLI-00147-000/BraTS-GLI-00147-000-seg.nii.gz,146,166,84,113,183,117,207,44,133,70,90,89
01129-000,../../DataSet/ASNR-MICCAI-BraTS2023-GLI-Challenge-TrainingData/BraTS-GLI-01129-000/BraTS-GLI-01129-000-t1c.nii.gz,../../DataSet/ASNR-MICCAI-BraTS2023-GLI-Challenge-TrainingData/BraTS-GLI-01129-000/BraTS-GLI-01129-000-t2w.nii.gz,../../DataSet/ASNR-MICCAI-BraTS2023-GLI-Challenge-TrainingData/BraTS-GLI-01129-000/BraTS-GLI-01129-000-t2f.nii.gz,../../DataSet/ASNR-MICCAI-BraTS2023-GLI-Challenge-TrainingData/BraTS-GLI-01129-000/BraTS-GLI-01129-000-t1n.nii.gz,../../DataSet/ASNR-MICCAI-BraTS2023-GLI-Challenge-TrainingData/BraTS-GLI-01129-000/BraTS-GLI-01129-000-seg.nii.gz,155,118,55,129,184,81,173,28,85,55,92,57
01144-000,../../DataSet/ASNR-MICCAI-BraTS2023-GLI-Challenge-TrainingData/BraTS-GLI-01144-000/BraTS-GLI-01144-000-t1c.nii.gz,../../DataSet/ASNR-MICCAI-BraTS2023-GLI-Challenge-TrainingData/BraTS-GLI-01144-000/BraTS-GLI-01144-000-t2w.nii.gz,../../DataSet/ASNR-MICCAI-BraTS2023-GLI-Challenge-TrainingData/BraTS-GLI-01144-000/BraTS-GLI-01144-000-t2f.nii.gz,../../DataSet/ASNR-MICCAI-BraTS2023-GLI-Challenge-TrainingData/BraTS-GLI-01144-000/BraTS-GLI-01144-000-t1n.nii.gz,../../DataSet/ASNR-MICCAI-BraTS2023-GLI-Challenge-TrainingData/BraTS-GLI-01144-000/BraTS-GLI-01144-000-seg.nii.gz,83,149,83,57,110,117,182,49,117,53,65,68
00704-000,../../DataSet/ASNR-MICCAI-BraTS2023-GLI-Challenge-TrainingData/BraTS-GLI-00704-000/BraTS-GLI-00704-000-t1c.nii.gz,../../DataSet/ASNR-MICCAI-BraTS2023-GLI-Challenge-TrainingData/BraTS-GLI-00704-000/BraTS-GLI-00704-000-t2w.nii.gz,../../DataSet/ASNR-MICCAI-BraTS2023-GLI-Challenge-TrainingData/BraTS-GLI-00704-000/BraTS-GLI-00704-000-t2f.nii.gz,../../DataSet/ASNR-MICCAI-BraTS2023-GLI-Challenge-TrainingData/BraTS-GLI-00704-000/BraTS-GLI-00704-000-t1n.nii.gz,../../DataSet/ASNR-MICCAI-BraTS2023-GLI-Challenge-TrainingData/BraTS-GLI-00704-000/BraTS-GLI-00704-000-seg.nii.gz,84,119,64,61,103,87,156,38,89,42,69,51
00540-001,../../DataSet/ASNR-MICCAI-BraTS2023-GLI-Challenge-TrainingData/BraTS-GLI-00540-001/BraTS-GLI-00540-001-t1c.nii.gz,../../DataSet/ASNR-MICCAI-BraTS2023-GLI-Challenge-TrainingData/BraTS-GLI-00540-001/BraTS-GLI-00540-001-t2w.nii.gz,../../DataSet/ASNR-MICCAI-BraTS2023-GLI-Challenge-TrainingData/BraTS-GLI-00540-001/BraTS-GLI-00540-001-t2f.nii.gz,../../DataSet/ASNR-MICCAI-BraTS2023-GLI-Challenge-TrainingData/BraTS-GLI-00540-001/BraTS-GLI-00540-001-t1n.nii.gz,../../DataSet/ASNR-MICCAI-BraTS2023-GLI-Challenge-TrainingData/BraTS-GLI-00540-001/BraTS-GLI-00540-001-seg.nii.gz,110,158,97,100,120,139,176,86,111,20,37,25
01282-000,../../DataSet/ASNR-MICCAI-BraTS2023-GLI-Challenge-TrainingData/BraTS-GLI-01282-000/BraTS-GLI-01282-000-t1c.nii.gz,../../DataSet/ASNR-MICCAI-BraTS2023-GLI-Challenge-TrainingData/BraTS-GLI-01282-000/BraTS-GLI-01282-000-t2w.nii.gz,../../DataSet/ASNR-MICCAI-BraTS2023-GLI-Challenge-TrainingData/BraTS-GLI-01282-000/BraTS-GLI-01282-000-t2f.nii.gz,../../DataSet/ASNR-MICCAI-BraTS2023-GLI-Challenge-TrainingData/BraTS-GLI-01282-000/BraTS-GLI-01282-000-t1n.nii.gz,../../DataSet/ASNR-MICCAI-BraTS2023-GLI-Challenge-TrainingData/BraTS-GLI-01282-000/BraTS-GLI-01282-000-seg.nii.gz,94,154,93,55,125,101,197,58,129,70,96,71
01525-000,../../DataSet/ASNR-MICCAI-BraTS2023-GLI-Challenge-TrainingData/BraTS-GLI-01525-000/BraTS-GLI-01525-000-t1c.nii.gz,../../DataSet/ASNR-MICCAI-BraTS2023-GLI-Challenge-TrainingData/BraTS-GLI-01525-000/BraTS-GLI-01525-000-t2w.nii.gz,../../DataSet/ASNR-MICCAI-BraTS2023-GLI-Challenge-TrainingData/BraTS-GLI-01525-000/BraTS-GLI-01525-000-t2f.nii.gz,../../DataSet/ASNR-MICCAI-BraTS2023-GLI-Challenge-TrainingData/BraTS-GLI-01525-000/BraTS-GLI-01525-000-t1n.nii.gz,../../DataSet/ASNR-MICCAI-BraTS2023-GLI-Challenge-TrainingData/BraTS-GLI-01525-000/BraTS-GLI-01525-000-seg.nii.gz,83,86,89,59,117,55,130,50,122,58,75,72
00413-000,../../DataSet/ASNR-MICCAI-BraTS2023-GLI-Challenge-TrainingData/BraTS-GLI-00413-000/BraTS-GLI-00413-000-t1c.nii.gz,../../DataSet/ASNR-MICCAI-BraTS2023-GLI-Challenge-TrainingData/BraTS-GLI-00413-000/BraTS-GLI-00413-000-t2w.nii.gz,../../DataSet/ASNR-MICCAI-BraTS2023-GLI-Challenge-TrainingData/BraTS-GLI-00413-000/BraTS-GLI-00413-000-t2f.nii.gz,../../DataSet/ASNR-MICCAI-BraTS2023-GLI-Challenge-TrainingData/BraTS-GLI-00413-000/BraTS-GLI-00413-000-t1n.nii.gz,../../DataSet/ASNR-MICCAI-BraTS2023-GLI-Challenge-TrainingData/BraTS-GLI-00413-000/BraTS-GLI-00413-000-seg.nii.gz,97,165,91,72,118,133,198,58,126,46,65,68
00072-000,../../DataSet/ASNR-MICCAI-BraTS2023-GLI-Challenge-TrainingData/BraTS-GLI-00072-000/BraTS-GLI-00072-000-t1c.nii.gz,../../DataSet/ASNR-MICCAI-BraTS2023-GLI-Challenge-TrainingData/BraTS-GLI-00072-000/BraTS-GLI-00072-000-t2w.nii.gz,../../DataSet/ASNR-MICCAI-BraTS2023-GLI-Challenge-TrainingData/BraTS-GLI-00072-000/BraTS-GLI-00072-000-t2f.nii.gz,../../DataSet/ASNR-MICCAI-BraTS2023-GLI-Challenge-TrainingData/BraTS-GLI-00072-000/BraTS-GLI-00072-000-t1n.nii.gz,../../DataSet/ASNR-MICCAI-BraTS2023-GLI-Challenge-TrainingData/BraTS-GLI-00072-000/BraTS-GLI-00072-000-seg.nii.gz,159,135,72,125,189,103,176,50,96,64,73,46
00778-000,../../DataSet/ASNR-MICCAI-BraTS2023-GLI-Challenge-TrainingData/BraTS-GLI-00778-000/BraTS-GLI-00778-000-t1c.nii.gz,../../DataSet/ASNR-MICCAI-BraTS2023-GLI-Challenge-TrainingData/BraTS-GLI-00778-000/BraTS-GLI-00778-000-t2w.nii.gz,../../DataSet/ASNR-MICCAI-BraTS2023-GLI-Challenge-TrainingData/BraTS-GLI-00778-000/BraTS-GLI-00778-000-t2f.nii.gz,../../DataSet/ASNR-MICCAI-BraTS2023-GLI-Challenge-TrainingData/BraTS-GLI-00778-000/BraTS-GLI-00778-000-t1n.nii.gz,../../DataSet/ASNR-MICCAI-BraTS2023-GLI-Challenge-TrainingData/BraTS-GLI-00778-000/BraTS-GLI-00778-000-seg.nii.gz,163,121,54,138,184,79,159,37,74,46,80,37
01377-000,../../DataSet/ASNR-MICCAI-BraTS2023-GLI-Challenge-TrainingData/BraTS-GLI-01377-000/BraTS-GLI-01377-000-t1c.nii.gz,../../DataSet/ASNR-MICCAI-BraTS2023-GLI-Challenge-TrainingData/BraTS-GLI-01377-000/BraTS-GLI-01377-000-t2w.nii.gz,../../DataSet/ASNR-MICCAI-BraTS2023-GLI-Challenge-TrainingData/BraTS-GLI-01377-000/BraTS-GLI-01377-000-t2f.nii.gz,../../DataSet/ASNR-MICCAI-BraTS2023-GLI-Challenge-TrainingData/BraTS-GLI-01377-000/BraTS-GLI-01377-000-t1n.nii.gz,../../DataSet/ASNR-MICCAI-BraTS2023-GLI-Challenge-TrainingData/BraTS-GLI-01377-000/BraTS-GLI-01377-000-seg.nii.gz,114,114,104,75,159,70,153,73,141,84,83,68
00290-000,../../DataSet/ASNR-MICCAI-BraTS2023-GLI-Challenge-TrainingData/BraTS-GLI-00290-000/BraTS-GLI-00290-000-t1c.nii.gz,../../DataSet/ASNR-MICCAI-BraTS2023-GLI-Challenge-TrainingData/BraTS-GLI-00290-000/BraTS-GLI-00290-000-t2w.nii.gz,../../DataSet/ASNR-MICCAI-BraTS2023-GLI-Challenge-TrainingData/BraTS-GLI-00290-000/BraTS-GLI-00290-000-t2f.nii.gz,../../DataSet/ASNR-MICCAI-BraTS2023-GLI-Challenge-TrainingData/BraTS-GLI-00290-000/BraTS-GLI-00290-000-t1n.nii.gz,../../DataSet/ASNR-MICCAI-BraTS2023-GLI-Challenge-TrainingData/BraTS-GLI-00290-000/BraTS-GLI-00290-000-seg.nii.gz,161,153,70,127,190,113,191,41,101,63,78,60
00537-000,../../DataSet/ASNR-MICCAI-BraTS2023-GLI-Challenge-TrainingData/BraTS-GLI-00537-000/BraTS-GLI-00537-000-t1c.nii.gz,../../DataSet/ASNR-MICCAI-BraTS2023-GLI-Challenge-TrainingData/BraTS-GLI-00537-000/BraTS-GLI-00537-000-t2w.nii.gz,../../DataSet/ASNR-MICCAI-BraTS2023-GLI-Challenge-TrainingData/BraTS-GLI-00537-000/BraTS-GLI-00537-000-t2f.nii.gz,../../DataSet/ASNR-MICCAI-BraTS2023-GLI-Challenge-TrainingData/BraTS-GLI-00537-000/BraTS-GLI-00537-000-t1n.nii.gz,../../DataSet/ASNR-MICCAI-BraTS2023-GLI-Challenge-TrainingData/BraTS-GLI-00537-000/BraTS-GLI-00537-000-seg.nii.gz,107,99,103,70,148,58,142,67,140,78,84,73
00156-000,../../DataSet/ASNR-MICCAI-BraTS2023-GLI-Challenge-TrainingData/BraTS-GLI-00156-000/BraTS-GLI-00156-000-t1c.nii.gz,../../DataSet/ASNR-MICCAI-BraTS2023-GLI-Challenge-TrainingData/BraTS-GLI-00156-000/BraTS-GLI-00156-000-t2w.nii.gz,../../DataSet/ASNR-MICCAI-BraTS2023-GLI-Challenge-TrainingData/BraTS-GLI-00156-000/BraTS-GLI-00156-000-t2f.nii.gz,../../DataSet/ASNR-MICCAI-BraTS2023-GLI-Challenge-TrainingData/BraTS-GLI-00156-000/BraTS-GLI-00156-000-t1n.nii.gz,../../DataSet/ASNR-MICCAI-BraTS2023-GLI-Challenge-TrainingData/BraTS-GLI-00156-000/BraTS-GLI-00156-000-seg.nii.gz,140,88,84,109,175,50,122,51,125,66,72,74
01060-000,../../DataSet/ASNR-MICCAI-BraTS2023-GLI-Challenge-TrainingData/BraTS-GLI-01060-000/BraTS-GLI-01060-000-t1c.nii.gz,../../DataSet/ASNR-MICCAI-BraTS2023-GLI-Challenge-TrainingData/BraTS-GLI-01060-000/BraTS-GLI-01060-000-t2w.nii.gz,../../DataSet/ASNR-MICCAI-BraTS2023-GLI-Challenge-TrainingData/BraTS-GLI-01060-000/BraTS-GLI-01060-000-t2f.nii.gz,../../DataSet/ASNR-MICCAI-BraTS2023-GLI-Challenge-TrainingData/BraTS-GLI-01060-000/BraTS-GLI-01060-000-t1n.nii.gz,../../DataSet/ASNR-MICCAI-BraTS2023-GLI-Challenge-TrainingData/BraTS-GLI-01060-000/BraTS-GLI-01060-000-seg.nii.gz,88,129,74,61,115,89,172,43,105,54,83,62
00620-000,../../DataSet/ASNR-MICCAI-BraTS2023-GLI-Challenge-TrainingData/BraTS-GLI-00620-000/BraTS-GLI-00620-000-t1c.nii.gz,../../DataSet/ASNR-MICCAI-BraTS2023-GLI-Challenge-TrainingData/BraTS-GLI-00620-000/BraTS-GLI-00620-000-t2w.nii.gz,../../DataSet/ASNR-MICCAI-BraTS2023-GLI-Challenge-TrainingData/BraTS-GLI-00620-000/BraTS-GLI-00620-000-t2f.nii.gz,../../DataSet/ASNR-MICCAI-BraTS2023-GLI-Challenge-TrainingData/BraTS-GLI-00620-000/BraTS-GLI-00620-000-t1n.nii.gz,../../DataSet/ASNR-MICCAI-BraTS2023-GLI-Challenge-TrainingData/BraTS-GLI-00620-000/BraTS-GLI-00620-000-seg.nii.gz,146,103,82,122,179,61,147,40,118,57,86,78
00187-000,../../DataSet/ASNR-MICCAI-BraTS2023-GLI-Challenge-TrainingData/BraTS-GLI-00187-000/BraTS-GLI-00187-000-t1c.nii.gz,../../DataSet/ASNR-MICCAI-BraTS2023-GLI-Challenge-TrainingData/BraTS-GLI-00187-000/BraTS-GLI-00187-000-t2w.nii.gz,../../DataSet/ASNR-MICCAI-BraTS2023-GLI-Challenge-TrainingData/BraTS-GLI-00187-000/BraTS-GLI-00187-000-t2f.nii.gz,../../DataSet/ASNR-MICCAI-BraTS2023-GLI-Challenge-TrainingData/BraTS-GLI-00187-000/BraTS-GLI-00187-000-t1n.nii.gz,../../DataSet/ASNR-MICCAI-BraTS2023-GLI-Challenge-TrainingData/BraTS-GLI-00187-000/BraTS-GLI-00187-000-seg.nii.gz,146,94,90,108,182,51,137,50,134,74,86,84
00464-001,../../DataSet/ASNR-MICCAI-BraTS2023-GLI-Challenge-TrainingData/BraTS-GLI-00464-001/BraTS-GLI-00464-001-t1c.nii.gz,../../DataSet/ASNR-MICCAI-BraTS2023-GLI-Challenge-TrainingData/BraTS-GLI-00464-001/BraTS-GLI-00464-001-t2w.nii.gz,../../DataSet/ASNR-MICCAI-BraTS2023-GLI-Challenge-TrainingData/BraTS-GLI-00464-001/BraTS-GLI-00464-001-t2f.nii.gz,../../DataSet/ASNR-MICCAI-BraTS2023-GLI-Challenge-TrainingData/BraTS-GLI-00464-001/BraTS-GLI-00464-001-t1n.nii.gz,../../DataSet/ASNR-MICCAI-BraTS2023-GLI-Challenge-TrainingData/BraTS-GLI-00464-001/BraTS-GLI-00464-001-seg.nii.gz,170,120,76,156,183,104,135,64,91,27,31,27
00241-000,../../DataSet/ASNR-MICCAI-BraTS2023-GLI-Challenge-TrainingData/BraTS-GLI-00241-000/BraTS-GLI-00241-000-t1c.nii.gz,../../DataSet/ASNR-MICCAI-BraTS2023-GLI-Challenge-TrainingData/BraTS-GLI-00241-000/BraTS-GLI-00241-000-t2w.nii.gz,../../DataSet/ASNR-MICCAI-BraTS2023-GLI-Challenge-TrainingData/BraTS-GLI-00241-000/BraTS-GLI-00241-000-t2f.nii.gz,../../DataSet/ASNR-MICCAI-BraTS2023-GLI-Challenge-TrainingData/BraTS-GLI-00241-000/BraTS-GLI-00241-000-t1n.nii.gz,../../DataSet/ASNR-MICCAI-BraTS2023-GLI-Challenge-TrainingData/BraTS-GLI-00241-000/BraTS-GLI-00241-000-seg.nii.gz,160,163,63,140,184,136,192,38,89,44,56,51
01401-000,../../DataSet/ASNR-MICCAI-BraTS2023-GLI-Challenge-TrainingData/BraTS-GLI-01401-000/BraTS-GLI-01401-000-t1c.nii.gz,../../DataSet/ASNR-MICCAI-BraTS2023-GLI-Challenge-TrainingData/BraTS-GLI-01401-000/BraTS-GLI-01401-000-t2w.nii.gz,../../DataSet/ASNR-MICCAI-BraTS2023-GLI-Challenge-TrainingData/BraTS-GLI-01401-000/BraTS-GLI-01401-000-t2f.nii.gz,../../DataSet/ASNR-MICCAI-BraTS2023-GLI-Challenge-TrainingData/BraTS-GLI-01401-000/BraTS-GLI-01401-000-t1n.nii.gz,../../DataSet/ASNR-MICCAI-BraTS2023-GLI-Challenge-TrainingData/BraTS-GLI-01401-000/BraTS-GLI-01401-000-seg.nii.gz,84,132,65,52,124,88,175,26,102,72,87,76
00009-000,../../DataSet/ASNR-MICCAI-BraTS2023-GLI-Challenge-TrainingData/BraTS-GLI-00009-000/BraTS-GLI-00009-000-t1c.nii.gz,../../DataSet/ASNR-MICCAI-BraTS2023-GLI-Challenge-TrainingData/BraTS-GLI-00009-000/BraTS-GLI-00009-000-t2w.nii.gz,../../DataSet/ASNR-MICCAI-BraTS2023-GLI-Challenge-TrainingData/BraTS-GLI-00009-000/BraTS-GLI-00009-000-t2f.nii.gz,../../DataSet/ASNR-MICCAI-BraTS2023-GLI-Challenge-TrainingData/BraTS-GLI-00009-000/BraTS-GLI-00009-000-t1n.nii.gz,../../DataSet/ASNR-MICCAI-BraTS2023-GLI-Challenge-TrainingData/BraTS-GLI-00009-000/BraTS-GLI-00009-000-seg.nii.gz,140,68,80,116,172,32,101,50,110,56,69,60
00530-000,../../DataSet/ASNR-MICCAI-BraTS2023-GLI-Challenge-TrainingData/BraTS-GLI-00530-000/BraTS-GLI-00530-000-t1c.nii.gz,../../DataSet/ASNR-MICCAI-BraTS2023-GLI-Challenge-TrainingData/BraTS-GLI-00530-000/BraTS-GLI-00530-000-t2w.nii.gz,../../DataSet/ASNR-MICCAI-BraTS2023-GLI-Challenge-TrainingData/BraTS-GLI-00530-000/BraTS-GLI-00530-000-t2f.nii.gz,../../DataSet/ASNR-MICCAI-BraTS2023-GLI-Challenge-TrainingData/BraTS-GLI-00530-000/BraTS-GLI-00530-000-t1n.nii.gz,../../DataSet/ASNR-MICCAI-BraTS2023-GLI-Challenge-TrainingData/BraTS-GLI-00530-000/BraTS-GLI-00530-000-seg.nii.gz,95,115,109,82,109,104,127,95,125,27,23,30
00297-000,../../DataSet/ASNR-MICCAI-BraTS2023-GLI-Challenge-TrainingData/BraTS-GLI-00297-000/BraTS-GLI-00297-000-t1c.nii.gz,../../DataSet/ASNR-MICCAI-BraTS2023-GLI-Challenge-TrainingData/BraTS-GLI-00297-000/BraTS-GLI-00297-000-t2w.nii.gz,../../DataSet/ASNR-MICCAI-BraTS2023-GLI-Challenge-TrainingData/BraTS-GLI-00297-000/BraTS-GLI-00297-000-t2f.nii.gz,../../DataSet/ASNR-MICCAI-BraTS2023-GLI-Challenge-TrainingData/BraTS-GLI-00297-000/BraTS-GLI-00297-000-t1n.nii.gz,../../DataSet/ASNR-MICCAI-BraTS2023-GLI-Challenge-TrainingData/BraTS-GLI-00297-000/BraTS-GLI-00297-000-seg.nii.gz,93,167,82,64,118,120,203,52,119,54,83,67
01370-000,../../DataSet/ASNR-MICCAI-BraTS2023-GLI-Challenge-TrainingData/BraTS-GLI-01370-000/BraTS-GLI-01370-000-t1c.nii.gz,../../DataSet/ASNR-MICCAI-BraTS2023-GLI-Challenge-TrainingData/BraTS-GLI-01370-000/BraTS-GLI-01370-000-t2w.nii.gz,../../DataSet/ASNR-MICCAI-BraTS2023-GLI-Challenge-TrainingData/BraTS-GLI-01370-000/BraTS-GLI-01370-000-t2f.nii.gz,../../DataSet/ASNR-MICCAI-BraTS2023-GLI-Challenge-TrainingData/BraTS-GLI-01370-000/BraTS-GLI-01370-000-t1n.nii.gz,../../DataSet/ASNR-MICCAI-BraTS2023-GLI-Challenge-TrainingData/BraTS-GLI-01370-000/BraTS-GLI-01370-000-seg.nii.gz,158,147,98,120,182,104,196,54,132,62,92,78
00151-000,../../DataSet/ASNR-MICCAI-BraTS2023-GLI-Challenge-TrainingData/BraTS-GLI-00151-000/BraTS-GLI-00151-000-t1c.nii.gz,../../DataSet/ASNR-MICCAI-BraTS2023-GLI-Challenge-TrainingData/BraTS-GLI-00151-000/BraTS-GLI-00151-000-t2w.nii.gz,../../DataSet/ASNR-MICCAI-BraTS2023-GLI-Challenge-TrainingData/BraTS-GLI-00151-000/BraTS-GLI-00151-000-t2f.nii.gz,../../DataSet/ASNR-MICCAI-BraTS2023-GLI-Challenge-TrainingData/BraTS-GLI-00151-000/BraTS-GLI-00151-000-t1n.nii.gz,../../DataSet/ASNR-MICCAI-BraTS2023-GLI-Challenge-TrainingData/BraTS-GLI-00151-000/BraTS-GLI-00151-000-seg.nii.gz,127,97,79,78,174,58,153,40,115,96,95,75
00774-001,../../DataSet/ASNR-MICCAI-BraTS2023-GLI-Challenge-TrainingData/BraTS-GLI-00774-001/BraTS-GLI-00774-001-t1c.nii.gz,../../DataSet/ASNR-MICCAI-BraTS2023-GLI-Challenge-TrainingData/BraTS-GLI-00774-001/BraTS-GLI-00774-001-t2w.nii.gz,../../DataSet/ASNR-MICCAI-BraTS2023-GLI-Challenge-TrainingData/BraTS-GLI-00774-001/BraTS-GLI-00774-001-t2f.nii.gz,../../DataSet/ASNR-MICCAI-BraTS2023-GLI-Challenge-TrainingData/BraTS-GLI-00774-001/BraTS-GLI-00774-001-t1n.nii.gz,../../DataSet/ASNR-MICCAI-BraTS2023-GLI-Challenge-TrainingData/BraTS-GLI-00774-001/BraTS-GLI-00774-001-seg.nii.gz,97,167,88,63,145,132,211,49,134,82,79,85
00246-000,../../DataSet/ASNR-MICCAI-BraTS2023-GLI-Challenge-TrainingData/BraTS-GLI-00246-000/BraTS-GLI-00246-000-t1c.nii.gz,../../DataSet/ASNR-MICCAI-BraTS2023-GLI-Challenge-TrainingData/BraTS-GLI-00246-000/BraTS-GLI-00246-000-t2w.nii.gz,../../DataSet/ASNR-MICCAI-BraTS2023-GLI-Challenge-TrainingData/BraTS-GLI-00246-000/BraTS-GLI-00246-000-t2f.nii.gz,../../DataSet/ASNR-MICCAI-BraTS2023-GLI-Challenge-TrainingData/BraTS-GLI-00246-000/BraTS-GLI-00246-000-t1n.nii.gz,../../DataSet/ASNR-MICCAI-BraTS2023-GLI-Challenge-TrainingData/BraTS-GLI-00246-000/BraTS-GLI-00246-000-seg.nii.gz,104,158,74,86,138,136,180,60,93,52,44,33
01522-000,../../DataSet/ASNR-MICCAI-BraTS2023-GLI-Challenge-TrainingData/BraTS-GLI-01522-000/BraTS-GLI-01522-000-t1c.nii.gz,../../DataSet/ASNR-MICCAI-BraTS2023-GLI-Challenge-TrainingData/BraTS-GLI-01522-000/BraTS-GLI-01522-000-t2w.nii.gz,../../DataSet/ASNR-MICCAI-BraTS2023-GLI-Challenge-TrainingData/BraTS-GLI-01522-000/BraTS-GLI-01522-000-t2f.nii.gz,../../DataSet/ASNR-MICCAI-BraTS2023-GLI-Challenge-TrainingData/BraTS-GLI-01522-000/BraTS-GLI-01522-000-t1n.nii.gz,../../DataSet/ASNR-MICCAI-BraTS2023-GLI-Challenge-TrainingData/BraTS-GLI-01522-000/BraTS-GLI-01522-000-seg.nii.gz,170,159,77,153,188,144,180,59,100,35,36,41
00547-001,../../DataSet/ASNR-MICCAI-BraTS2023-GLI-Challenge-TrainingData/BraTS-GLI-00547-001/BraTS-GLI-00547-001-t1c.nii.gz,../../DataSet/ASNR-MICCAI-BraTS2023-GLI-Challenge-TrainingData/BraTS-GLI-00547-001/BraTS-GLI-00547-001-t2w.nii.gz,../../DataSet/ASNR-MICCAI-BraTS2023-GLI-Challenge-TrainingData/BraTS-GLI-00547-001/BraTS-GLI-00547-001-t2f.nii.gz,../../DataSet/ASNR-MICCAI-BraTS2023-GLI-Challenge-TrainingData/BraTS-GLI-00547-001/BraTS-GLI-00547-001-t1n.nii.gz,../../DataSet/ASNR-MICCAI-BraTS2023-GLI-Challenge-TrainingData/BraTS-GLI-00547-001/BraTS-GLI-00547-001-seg.nii.gz,153,112,99,130,178,78,143,77,128,48,65,51
00414-000,../../DataSet/ASNR-MICCAI-BraTS2023-GLI-Challenge-TrainingData/BraTS-GLI-00414-000/BraTS-GLI-00414-000-t1c.nii.gz,../../DataSet/ASNR-MICCAI-BraTS2023-GLI-Challenge-TrainingData/BraTS-GLI-00414-000/BraTS-GLI-00414-000-t2w.nii.gz,../../DataSet/ASNR-MICCAI-BraTS2023-GLI-Challenge-TrainingData/BraTS-GLI-00414-000/BraTS-GLI-00414-000-t2f.nii.gz,../../DataSet/ASNR-MICCAI-BraTS2023-GLI-Challenge-TrainingData/BraTS-GLI-00414-000/BraTS-GLI-00414-000-t1n.nii.gz,../../DataSet/ASNR-MICCAI-BraTS2023-GLI-Challenge-TrainingData/BraTS-GLI-00414-000/BraTS-GLI-00414-000-seg.nii.gz,158,149,72,130,182,104,187,39,106,52,83,67
00708-001,../../DataSet/ASNR-MICCAI-BraTS2023-GLI-Challenge-TrainingData/BraTS-GLI-00708-001/BraTS-GLI-00708-001-t1c.nii.gz,../../DataSet/ASNR-MICCAI-BraTS2023-GLI-Challenge-TrainingData/BraTS-GLI-00708-001/BraTS-GLI-00708-001-t2w.nii.gz,../../DataSet/ASNR-MICCAI-BraTS2023-GLI-Challenge-TrainingData/BraTS-GLI-00708-001/BraTS-GLI-00708-001-t2f.nii.gz,../../DataSet/ASNR-MICCAI-BraTS2023-GLI-Challenge-TrainingData/BraTS-GLI-00708-001/BraTS-GLI-00708-001-t1n.nii.gz,../../DataSet/ASNR-MICCAI-BraTS2023-GLI-Challenge-TrainingData/BraTS-GLI-00708-001/BraTS-GLI-00708-001-seg.nii.gz,142,166,102,123,166,146,192,78,127,43,46,49
01131-000,../../DataSet/ASNR-MICCAI-BraTS2023-GLI-Challenge-TrainingData/BraTS-GLI-01131-000/BraTS-GLI-01131-000-t1c.nii.gz,../../DataSet/ASNR-MICCAI-BraTS2023-GLI-Challenge-TrainingData/BraTS-GLI-01131-000/BraTS-GLI-01131-000-t2w.nii.gz,../../DataSet/ASNR-MICCAI-BraTS2023-GLI-Challenge-TrainingData/BraTS-GLI-01131-000/BraTS-GLI-01131-000-t2f.nii.gz,../../DataSet/ASNR-MICCAI-BraTS2023-GLI-Challenge-TrainingData/BraTS-GLI-01131-000/BraTS-GLI-01131-000-t1n.nii.gz,../../DataSet/ASNR-MICCAI-BraTS2023-GLI-Challenge-TrainingData/BraTS-GLI-01131-000/BraTS-GLI-01131-000-seg.nii.gz,74,122,92,53,97,97,146,72,120,44,49,48
00310-000,../../DataSet/ASNR-MICCAI-BraTS2023-GLI-Challenge-TrainingData/BraTS-GLI-00310-000/BraTS-GLI-00310-000-t1c.nii.gz,../../DataSet/ASNR-MICCAI-BraTS2023-GLI-Challenge-TrainingData/BraTS-GLI-00310-000/BraTS-GLI-00310-000-t2w.nii.gz,../../DataSet/ASNR-MICCAI-BraTS2023-GLI-Challenge-TrainingData/BraTS-GLI-00310-000/BraTS-GLI-00310-000-t2f.nii.gz,../../DataSet/ASNR-MICCAI-BraTS2023-GLI-Challenge-TrainingData/BraTS-GLI-00310-000/BraTS-GLI-00310-000-t1n.nii.gz,../../DataSet/ASNR-MICCAI-BraTS2023-GLI-Challenge-TrainingData/BraTS-GLI-00310-000/BraTS-GLI-00310-000-seg.nii.gz,94,156,88,65,125,121,193,49,128,60,72,79
01226-000,../../DataSet/ASNR-MICCAI-BraTS2023-GLI-Challenge-TrainingData/BraTS-GLI-01226-000/BraTS-GLI-01226-000-t1c.nii.gz,../../DataSet/ASNR-MICCAI-BraTS2023-GLI-Challenge-TrainingData/BraTS-GLI-01226-000/BraTS-GLI-01226-000-t2w.nii.gz,../../DataSet/ASNR-MICCAI-BraTS2023-GLI-Challenge-TrainingData/BraTS-GLI-01226-000/BraTS-GLI-01226-000-t2f.nii.gz,../../DataSet/ASNR-MICCAI-BraTS2023-GLI-Challenge-TrainingData/BraTS-GLI-01226-000/BraTS-GLI-01226-000-t1n.nii.gz,../../DataSet/ASNR-MICCAI-BraTS2023-GLI-Challenge-TrainingData/BraTS-GLI-01226-000/BraTS-GLI-01226-000-seg.nii.gz,155,160,79,126,184,118,202,32,120,58,84,88
00466-000,../../DataSet/ASNR-MICCAI-BraTS2023-GLI-Challenge-TrainingData/BraTS-GLI-00466-000/BraTS-GLI-00466-000-t1c.nii.gz,../../DataSet/ASNR-MICCAI-BraTS2023-GLI-Challenge-TrainingData/BraTS-GLI-00466-000/BraTS-GLI-00466-000-t2w.nii.gz,../../DataSet/ASNR-MICCAI-BraTS2023-GLI-Challenge-TrainingData/BraTS-GLI-00466-000/BraTS-GLI-00466-000-t2f.nii.gz,../../DataSet/ASNR-MICCAI-BraTS2023-GLI-Challenge-TrainingData/BraTS-GLI-00466-000/BraTS-GLI-00466-000-t1n.nii.gz,../../DataSet/ASNR-MICCAI-BraTS2023-GLI-Challenge-TrainingData/BraTS-GLI-00466-000/BraTS-GLI-00466-000-seg.nii.gz,97,97,104,67,128,54,143,71,139,61,89,68
00814-000,../../DataSet/ASNR-MICCAI-BraTS2023-GLI-Challenge-TrainingData/BraTS-GLI-00814-000/BraTS-GLI-00814-000-t1c.nii.gz,../../DataSet/ASNR-MICCAI-BraTS2023-GLI-Challenge-TrainingData/BraTS-GLI-00814-000/BraTS-GLI-00814-000-t2w.nii.gz,../../DataSet/ASNR-MICCAI-BraTS2023-GLI-Challenge-TrainingData/BraTS-GLI-00814-000/BraTS-GLI-00814-000-t2f.nii.gz,../../DataSet/ASNR-MICCAI-BraTS2023-GLI-Challenge-TrainingData/BraTS-GLI-00814-000/BraTS-GLI-00814-000-t1n.nii.gz,../../DataSet/ASNR-MICCAI-BraTS2023-GLI-Challenge-TrainingData/BraTS-GLI-00814-000/BraTS-GLI-00814-000-seg.nii.gz,156,129,70,126,183,86,172,34,106,57,86,72
00299-000,../../DataSet/ASNR-MICCAI-BraTS2023-GLI-Challenge-TrainingData/BraTS-GLI-00299-000/BraTS-GLI-00299-000-t1c.nii.gz,../../DataSet/ASNR-MICCAI-BraTS2023-GLI-Challenge-TrainingData/BraTS-GLI-00299-000/BraTS-GLI-00299-000-t2w.nii.gz,../../DataSet/ASNR-MICCAI-BraTS2023-GLI-Challenge-TrainingData/BraTS-GLI-00299-000/BraTS-GLI-00299-000-t2f.nii.gz,../../DataSet/ASNR-MICCAI-BraTS2023-GLI-Challenge-TrainingData/BraTS-GLI-00299-000/BraTS-GLI-00299-000-t1n.nii.gz,../../DataSet/ASNR-MICCAI-BraTS2023-GLI-Challenge-TrainingData/BraTS-GLI-00299-000/BraTS-GLI-00299-000-seg.nii.gz,88,174,62,60,114,139,205,34,102,54,66,68
01069-000,../../DataSet/ASNR-MICCAI-BraTS2023-GLI-Challenge-TrainingData/BraTS-GLI-01069-000/BraTS-GLI-01069-000-t1c.nii.gz,../../DataSet/ASNR-MICCAI-BraTS2023-GLI-Challenge-TrainingData/BraTS-GLI-01069-000/BraTS-GLI-01069-000-t2w.nii.gz,../../DataSet/ASNR-MICCAI-BraTS2023-GLI-Challenge-TrainingData/BraTS-GLI-01069-000/BraTS-GLI-01069-000-t2f.nii.gz,../../DataSet/ASNR-MICCAI-BraTS2023-GLI-Challenge-TrainingData/BraTS-GLI-01069-000/BraTS-GLI-01069-000-t1n.nii.gz,../../DataSet/ASNR-MICCAI-BraTS2023-GLI-Challenge-TrainingData/BraTS-GLI-01069-000/BraTS-GLI-01069-000-seg.nii.gz,155,152,87,126,185,109,201,56,123,59,92,67
01408-000,../../DataSet/ASNR-MICCAI-BraTS2023-GLI-Challenge-TrainingData/BraTS-GLI-01408-000/BraTS-GLI-01408-000-t1c.nii.gz,../../DataSet/ASNR-MICCAI-BraTS2023-GLI-Challenge-TrainingData/BraTS-GLI-01408-000/BraTS-GLI-01408-000-t2w.nii.gz,../../DataSet/ASNR-MICCAI-BraTS2023-GLI-Challenge-TrainingData/BraTS-GLI-01408-000/BraTS-GLI-01408-000-t2f.nii.gz,../../DataSet/ASNR-MICCAI-BraTS2023-GLI-Challenge-TrainingData/BraTS-GLI-01408-000/BraTS-GLI-01408-000-t1n.nii.gz,../../DataSet/ASNR-MICCAI-BraTS2023-GLI-Challenge-TrainingData/BraTS-GLI-01408-000/BraTS-GLI-01408-000-seg.nii.gz,70,144,55,51,93,118,171,35,78,42,53,43
00549-001,../../DataSet/ASNR-MICCAI-BraTS2023-GLI-Challenge-TrainingData/BraTS-GLI-00549-001/BraTS-GLI-00549-001-t1c.nii.gz,../../DataSet/ASNR-MICCAI-BraTS2023-GLI-Challenge-TrainingData/BraTS-GLI-00549-001/BraTS-GLI-00549-001-t2w.nii.gz,../../DataSet/ASNR-MICCAI-BraTS2023-GLI-Challenge-TrainingData/BraTS-GLI-00549-001/BraTS-GLI-00549-001-t2f.nii.gz,../../DataSet/ASNR-MICCAI-BraTS2023-GLI-Challenge-TrainingData/BraTS-GLI-00549-001/BraTS-GLI-00549-001-t1n.nii.gz,../../DataSet/ASNR-MICCAI-BraTS2023-GLI-Challenge-TrainingData/BraTS-GLI-00549-001/BraTS-GLI-00549-001-seg.nii.gz,96,101,95,61,138,54,145,61,136,77,91,75
00684-000,../../DataSet/ASNR-MICCAI-BraTS2023-GLI-Challenge-TrainingData/BraTS-GLI-00684-000/BraTS-GLI-00684-000-t1c.nii.gz,../../DataSet/ASNR-MICCAI-BraTS2023-GLI-Challenge-TrainingData/BraTS-GLI-00684-000/BraTS-GLI-00684-000-t2w.nii.gz,../../DataSet/ASNR-MICCAI-BraTS2023-GLI-Challenge-TrainingData/BraTS-GLI-00684-000/BraTS-GLI-00684-000-t2f.nii.gz,../../DataSet/ASNR-MICCAI-BraTS2023-GLI-Challenge-TrainingData/BraTS-GLI-00684-000/BraTS-GLI-00684-000-t1n.nii.gz,../../DataSet/ASNR-MICCAI-BraTS2023-GLI-Challenge-TrainingData/BraTS-GLI-00684-000/BraTS-GLI-00684-000-seg.nii.gz,124,107,118,111,139,79,127,91,142,28,48,51
00234-000,../../DataSet/ASNR-MICCAI-BraTS2023-GLI-Challenge-TrainingData/BraTS-GLI-00234-000/BraTS-GLI-00234-000-t1c.nii.gz,../../DataSet/ASNR-MICCAI-BraTS2023-GLI-Challenge-TrainingData/BraTS-GLI-00234-000/BraTS-GLI-00234-000-t2w.nii.gz,../../DataSet/ASNR-MICCAI-BraTS2023-GLI-Challenge-TrainingData/BraTS-GLI-00234-000/BraTS-GLI-00234-000-t2f.nii.gz,../../DataSet/ASNR-MICCAI-BraTS2023-GLI-Challenge-TrainingData/BraTS-GLI-00234-000/BraTS-GLI-00234-000-t1n.nii.gz,../../DataSet/ASNR-MICCAI-BraTS2023-GLI-Challenge-TrainingData/BraTS-GLI-00234-000/BraTS-GLI-00234-000-seg.nii.gz,92,110,68,61,126,69,157,34,100,65,88,66
00593-000,../../DataSet/ASNR-MICCAI-BraTS2023-GLI-Challenge-TrainingData/BraTS-GLI-00593-000/BraTS-GLI-00593-000-t1c.nii.gz,../../DataSet/ASNR-MICCAI-BraTS2023-GLI-Challenge-TrainingData/BraTS-GLI-00593-000/BraTS-GLI-00593-000-t2w.nii.gz,../../DataSet/ASNR-MICCAI-BraTS2023-GLI-Challenge-TrainingData/BraTS-GLI-00593-000/BraTS-GLI-00593-000-t2f.nii.gz,../../DataSet/ASNR-MICCAI-BraTS2023-GLI-Challenge-TrainingData/BraTS-GLI-00593-000/BraTS-GLI-00593-000-t1n.nii.gz,../../DataSet/ASNR-MICCAI-BraTS2023-GLI-Challenge-TrainingData/BraTS-GLI-00593-000/BraTS-GLI-00593-000-seg.nii.gz,137,152,94,117,165,115,185,63,126,48,70,63
01474-000,../../DataSet/ASNR-MICCAI-BraTS2023-GLI-Challenge-TrainingData/BraTS-GLI-01474-000/BraTS-GLI-01474-000-t1c.nii.gz,../../DataSet/ASNR-MICCAI-BraTS2023-GLI-Challenge-TrainingData/BraTS-GLI-01474-000/BraTS-GLI-01474-000-t2w.nii.gz,../../DataSet/ASNR-MICCAI-BraTS2023-GLI-Challenge-TrainingData/BraTS-GLI-01474-000/BraTS-GLI-01474-000-t2f.nii.gz,../../DataSet/ASNR-MICCAI-BraTS2023-GLI-Challenge-TrainingData/BraTS-GLI-01474-000/BraTS-GLI-01474-000-t1n.nii.gz,../../DataSet/ASNR-MICCAI-BraTS2023-GLI-Challenge-TrainingData/BraTS-GLI-01474-000/BraTS-GLI-01474-000-seg.nii.gz,157,155,67,129,184,119,186,40,95,55,67,55
00545-000,../../DataSet/ASNR-MICCAI-BraTS2023-GLI-Challenge-TrainingData/BraTS-GLI-00545-000/BraTS-GLI-00545-000-t1c.nii.gz,../../DataSet/ASNR-MICCAI-BraTS2023-GLI-Challenge-TrainingData/BraTS-GLI-00545-000/BraTS-GLI-00545-000-t2w.nii.gz,../../DataSet/ASNR-MICCAI-BraTS2023-GLI-Challenge-TrainingData/BraTS-GLI-00545-000/BraTS-GLI-00545-000-t2f.nii.gz,../../DataSet/ASNR-MICCAI-BraTS2023-GLI-Challenge-TrainingData/BraTS-GLI-00545-000/BraTS-GLI-00545-000-t1n.nii.gz,../../DataSet/ASNR-MICCAI-BraTS2023-GLI-Challenge-TrainingData/BraTS-GLI-00545-000/BraTS-GLI-00545-000-seg.nii.gz,164,123,57,131,186,87,160,29,87,55,73,58
01305-000,../../DataSet/ASNR-MICCAI-BraTS2023-GLI-Challenge-TrainingData/BraTS-GLI-01305-000/BraTS-GLI-01305-000-t1c.nii.gz,../../DataSet/ASNR-MICCAI-BraTS2023-GLI-Challenge-TrainingData/BraTS-GLI-01305-000/BraTS-GLI-01305-000-t2w.nii.gz,../../DataSet/ASNR-MICCAI-BraTS2023-GLI-Challenge-TrainingData/BraTS-GLI-01305-000/BraTS-GLI-01305-000-t2f.nii.gz,../../DataSet/ASNR-MICCAI-BraTS2023-GLI-Challenge-TrainingData/BraTS-GLI-01305-000/BraTS-GLI-01305-000-t1n.nii.gz,../../DataSet/ASNR-MICCAI-BraTS2023-GLI-Challenge-TrainingData/BraTS-GLI-01305-000/BraTS-GLI-01305-000-seg.nii.gz,112,99,97,81,151,65,132,65,132,70,67,67
00683-000,../../DataSet/ASNR-MICCAI-BraTS2023-GLI-Challenge-TrainingData/BraTS-GLI-00683-000/BraTS-GLI-00683-000-t1c.nii.gz,../../DataSet/ASNR-MICCAI-BraTS2023-GLI-Challenge-TrainingData/BraTS-GLI-00683-000/BraTS-GLI-00683-000-t2w.nii.gz,../../DataSet/ASNR-MICCAI-BraTS2023-GLI-Challenge-TrainingData/BraTS-GLI-00683-000/BraTS-GLI-00683-000-t2f.nii.gz,../../DataSet/ASNR-MICCAI-BraTS2023-GLI-Challenge-TrainingData/BraTS-GLI-00683-000/BraTS-GLI-00683-000-t1n.nii.gz,../../DataSet/ASNR-MICCAI-BraTS2023-GLI-Challenge-TrainingData/BraTS-GLI-00683-000/BraTS-GLI-00683-000-seg.nii.gz,158,150,67,126,190,102,197,33,104,64,95,71
00594-000,../../DataSet/ASNR-MICCAI-BraTS2023-GLI-Challenge-TrainingData/BraTS-GLI-00594-000/BraTS-GLI-00594-000-t1c.nii.gz,../../DataSet/ASNR-MICCAI-BraTS2023-GLI-Challenge-TrainingData/BraTS-GLI-00594-000/BraTS-GLI-00594-000-t2w.nii.gz,../../DataSet/ASNR-MICCAI-BraTS2023-GLI-Challenge-TrainingData/BraTS-GLI-00594-000/BraTS-GLI-00594-000-t2f.nii.gz,../../DataSet/ASNR-MICCAI-BraTS2023-GLI-Challenge-TrainingData/BraTS-GLI-00594-000/BraTS-GLI-00594-000-t1n.nii.gz,../../DataSet/ASNR-MICCAI-BraTS2023-GLI-Challenge-TrainingData/BraTS-GLI-00594-000/BraTS-GLI-00594-000-seg.nii.gz,112,131,93,89,162,83,172,65,126,73,89,61
00233-000,../../DataSet/ASNR-MICCAI-BraTS2023-GLI-Challenge-TrainingData/BraTS-GLI-00233-000/BraTS-GLI-00233-000-t1c.nii.gz,../../DataSet/ASNR-MICCAI-BraTS2023-GLI-Challenge-TrainingData/BraTS-GLI-00233-000/BraTS-GLI-00233-000-t2w.nii.gz,../../DataSet/ASNR-MICCAI-BraTS2023-GLI-Challenge-TrainingData/BraTS-GLI-00233-000/BraTS-GLI-00233-000-t2f.nii.gz,../../DataSet/ASNR-MICCAI-BraTS2023-GLI-Challenge-TrainingData/BraTS-GLI-00233-000/BraTS-GLI-00233-000-t1n.nii.gz,../../DataSet/ASNR-MICCAI-BraTS2023-GLI-Challenge-TrainingData/BraTS-GLI-00233-000/BraTS-GLI-00233-000-seg.nii.gz,93,122,91,66,120,86,161,61,124,54,75,63
00317-000,../../DataSet/ASNR-MICCAI-BraTS2023-GLI-Challenge-TrainingData/BraTS-GLI-00317-000/BraTS-GLI-00317-000-t1c.nii.gz,../../DataSet/ASNR-MICCAI-BraTS2023-GLI-Challenge-TrainingData/BraTS-GLI-00317-000/BraTS-GLI-00317-000-t2w.nii.gz,../../DataSet/ASNR-MICCAI-BraTS2023-GLI-Challenge-TrainingData/BraTS-GLI-00317-000/BraTS-GLI-00317-000-t2f.nii.gz,../../DataSet/ASNR-MICCAI-BraTS2023-GLI-Challenge-TrainingData/BraTS-GLI-00317-000/BraTS-GLI-00317-000-t1n.nii.gz,../../DataSet/ASNR-MICCAI-BraTS2023-GLI-Challenge-TrainingData/BraTS-GLI-00317-000/BraTS-GLI-00317-000-seg.nii.gz,102,108,105,80,123,81,138,75,137,43,57,62
00000-000,../../DataSet/ASNR-MICCAI-BraTS2023-GLI-Challenge-TrainingData/BraTS-GLI-00000-000/BraTS-GLI-00000-000-t1c.nii.gz,../../DataSet/ASNR-MICCAI-BraTS2023-GLI-Challenge-TrainingData/BraTS-GLI-00000-000/BraTS-GLI-00000-000-t2w.nii.gz,../../DataSet/ASNR-MICCAI-BraTS2023-GLI-Challenge-TrainingData/BraTS-GLI-00000-000/BraTS-GLI-00000-000-t2f.nii.gz,../../DataSet/ASNR-MICCAI-BraTS2023-GLI-Challenge-TrainingData/BraTS-GLI-00000-000/BraTS-GLI-00000-000-t1n.nii.gz,../../DataSet/ASNR-MICCAI-BraTS2023-GLI-Challenge-TrainingData/BraTS-GLI-00000-000/BraTS-GLI-00000-000-seg.nii.gz,139,83,71,119,164,46,121,50,96,45,75,46
00539-000,../../DataSet/ASNR-MICCAI-BraTS2023-GLI-Challenge-TrainingData/BraTS-GLI-00539-000/BraTS-GLI-00539-000-t1c.nii.gz,../../DataSet/ASNR-MICCAI-BraTS2023-GLI-Challenge-TrainingData/BraTS-GLI-00539-000/BraTS-GLI-00539-000-t2w.nii.gz,../../DataSet/ASNR-MICCAI-BraTS2023-GLI-Challenge-TrainingData/BraTS-GLI-00539-000/BraTS-GLI-00539-000-t2f.nii.gz,../../DataSet/ASNR-MICCAI-BraTS2023-GLI-Challenge-TrainingData/BraTS-GLI-00539-000/BraTS-GLI-00539-000-t1n.nii.gz,../../DataSet/ASNR-MICCAI-BraTS2023-GLI-Challenge-TrainingData/BraTS-GLI-00539-000/BraTS-GLI-00539-000-seg.nii.gz,162,138,85,129,190,98,180,45,122,61,82,77
01379-000,../../DataSet/ASNR-MICCAI-BraTS2023-GLI-Challenge-TrainingData/BraTS-GLI-01379-000/BraTS-GLI-01379-000-t1c.nii.gz,../../DataSet/ASNR-MICCAI-BraTS2023-GLI-Challenge-TrainingData/BraTS-GLI-01379-000/BraTS-GLI-01379-000-t2w.nii.gz,../../DataSet/ASNR-MICCAI-BraTS2023-GLI-Challenge-TrainingData/BraTS-GLI-01379-000/BraTS-GLI-01379-000-t2f.nii.gz,../../DataSet/ASNR-MICCAI-BraTS2023-GLI-Challenge-TrainingData/BraTS-GLI-01379-000/BraTS-GLI-01379-000-t1n.nii.gz,../../DataSet/ASNR-MICCAI-BraTS2023-GLI-Challenge-TrainingData/BraTS-GLI-01379-000/BraTS-GLI-01379-000-seg.nii.gz,137,182,71,93,160,149,211,43,101,67,62,58
00049-000,../../DataSet/ASNR-MICCAI-BraTS2023-GLI-Challenge-TrainingData/BraTS-GLI-00049-000/BraTS-GLI-00049-000-t1c.nii.gz,../../DataSet/ASNR-MICCAI-BraTS2023-GLI-Challenge-TrainingData/BraTS-GLI-00049-000/BraTS-GLI-00049-000-t2w.nii.gz,../../DataSet/ASNR-MICCAI-BraTS2023-GLI-Challenge-TrainingData/BraTS-GLI-00049-000/BraTS-GLI-00049-000-t2f.nii.gz,../../DataSet/ASNR-MICCAI-BraTS2023-GLI-Challenge-TrainingData/BraTS-GLI-00049-000/BraTS-GLI-00049-000-t1n.nii.gz,../../DataSet/ASNR-MICCAI-BraTS2023-GLI-Challenge-TrainingData/BraTS-GLI-00049-000/BraTS-GLI-00049-000-seg.nii.gz,145,99,99,120,178,55,140,68,132,58,85,64
01268-000,../../DataSet/ASNR-MICCAI-BraTS2023-GLI-Challenge-TrainingData/BraTS-GLI-01268-000/BraTS-GLI-01268-000-t1c.nii.gz,../../DataSet/ASNR-MICCAI-BraTS2023-GLI-Challenge-TrainingData/BraTS-GLI-01268-000/BraTS-GLI-01268-000-t2w.nii.gz,../../DataSet/ASNR-MICCAI-BraTS2023-GLI-Challenge-TrainingData/BraTS-GLI-01268-000/BraTS-GLI-01268-000-t2f.nii.gz,../../DataSet/ASNR-MICCAI-BraTS2023-GLI-Challenge-TrainingData/BraTS-GLI-01268-000/BraTS-GLI-01268-000-t1n.nii.gz,../../DataSet/ASNR-MICCAI-BraTS2023-GLI-Challenge-TrainingData/BraTS-GLI-01268-000/BraTS-GLI-01268-000-seg.nii.gz,153,148,86,129,180,116,174,64,114,51,58,50
01446-000,../../DataSet/ASNR-MICCAI-BraTS2023-GLI-Challenge-TrainingData/BraTS-GLI-01446-000/BraTS-GLI-01446-000-t1c.nii.gz,../../DataSet/ASNR-MICCAI-BraTS2023-GLI-Challenge-TrainingData/BraTS-GLI-01446-000/BraTS-GLI-01446-000-t2w.nii.gz,../../DataSet/ASNR-MICCAI-BraTS2023-GLI-Challenge-TrainingData/BraTS-GLI-01446-000/BraTS-GLI-01446-000-t2f.nii.gz,../../DataSet/ASNR-MICCAI-BraTS2023-GLI-Challenge-TrainingData/BraTS-GLI-01446-000/BraTS-GLI-01446-000-t1n.nii.gz,../../DataSet/ASNR-MICCAI-BraTS2023-GLI-Challenge-TrainingData/BraTS-GLI-01446-000/BraTS-GLI-01446-000-seg.nii.gz,79,128,62,53,112,89,176,34,92,59,87,58
00206-000,../../DataSet/ASNR-MICCAI-BraTS2023-GLI-Challenge-TrainingData/BraTS-GLI-00206-000/BraTS-GLI-00206-000-t1c.nii.gz,../../DataSet/ASNR-MICCAI-BraTS2023-GLI-Challenge-TrainingData/BraTS-GLI-00206-000/BraTS-GLI-00206-000-t2w.nii.gz,../../DataSet/ASNR-MICCAI-BraTS2023-GLI-Challenge-TrainingData/BraTS-GLI-00206-000/BraTS-GLI-00206-000-t2f.nii.gz,../../DataSet/ASNR-MICCAI-BraTS2023-GLI-Challenge-TrainingData/BraTS-GLI-00206-000/BraTS-GLI-00206-000-t1n.nii.gz,../../DataSet/ASNR-MICCAI-BraTS2023-GLI-Challenge-TrainingData/BraTS-GLI-00206-000/BraTS-GLI-00206-000-seg.nii.gz,99,124,117,72,116,64,157,98,139,44,93,41
00667-000,../../DataSet/ASNR-MICCAI-BraTS2023-GLI-Challenge-TrainingData/BraTS-GLI-00667-000/BraTS-GLI-00667-000-t1c.nii.gz,../../DataSet/ASNR-MICCAI-BraTS2023-GLI-Challenge-TrainingData/BraTS-GLI-00667-000/BraTS-GLI-00667-000-t2w.nii.gz,../../DataSet/ASNR-MICCAI-BraTS2023-GLI-Challenge-TrainingData/BraTS-GLI-00667-000/BraTS-GLI-00667-000-t2f.nii.gz,../../DataSet/ASNR-MICCAI-BraTS2023-GLI-Challenge-TrainingData/BraTS-GLI-00667-000/BraTS-GLI-00667-000-t1n.nii.gz,../../DataSet/ASNR-MICCAI-BraTS2023-GLI-Challenge-TrainingData/BraTS-GLI-00667-000/BraTS-GLI-00667-000-seg.nii.gz,101,77,82,73,132,37,113,52,116,59,76,64
00111-000,../../DataSet/ASNR-MICCAI-BraTS2023-GLI-Challenge-TrainingData/BraTS-GLI-00111-000/BraTS-GLI-00111-000-t1c.nii.gz,../../DataSet/ASNR-MICCAI-BraTS2023-GLI-Challenge-TrainingData/BraTS-GLI-00111-000/BraTS-GLI-00111-000-t2w.nii.gz,../../DataSet/ASNR-MICCAI-BraTS2023-GLI-Challenge-TrainingData/BraTS-GLI-00111-000/BraTS-GLI-00111-000-t2f.nii.gz,../../DataSet/ASNR-MICCAI-BraTS2023-GLI-Challenge-TrainingData/BraTS-GLI-00111-000/BraTS-GLI-00111-000-t1n.nii.gz,../../DataSet/ASNR-MICCAI-BraTS2023-GLI-Challenge-TrainingData/BraTS-GLI-00111-000/BraTS-GLI-00111-000-seg.nii.gz,153,129,68,117,179,85,174,30,103,62,89,73
00570-000,../../DataSet/ASNR-MICCAI-BraTS2023-GLI-Challenge-TrainingData/BraTS-GLI-00570-000/BraTS-GLI-00570-000-t1c.nii.gz,../../DataSet/ASNR-MICCAI-BraTS2023-GLI-Challenge-TrainingData/BraTS-GLI-00570-000/BraTS-GLI-00570-000-t2w.nii.gz,../../DataSet/ASNR-MICCAI-BraTS2023-GLI-Challenge-TrainingData/BraTS-GLI-00570-000/BraTS-GLI-00570-000-t2f.nii.gz,../../DataSet/ASNR-MICCAI-BraTS2023-GLI-Challenge-TrainingData/BraTS-GLI-00570-000/BraTS-GLI-00570-000-t1n.nii.gz,../../DataSet/ASNR-MICCAI-BraTS2023-GLI-Challenge-TrainingData/BraTS-GLI-00570-000/BraTS-GLI-00570-000-seg.nii.gz,87,124,88,65,115,90,175,67,111,50,85,44
01497-000,../../DataSet/ASNR-MICCAI-BraTS2023-GLI-Challenge-TrainingData/BraTS-GLI-01497-000/BraTS-GLI-01497-000-t1c.nii.gz,../../DataSet/ASNR-MICCAI-BraTS2023-GLI-Challenge-TrainingData/BraTS-GLI-01497-000/BraTS-GLI-01497-000-t2w.nii.gz,../../DataSet/ASNR-MICCAI-BraTS2023-GLI-Challenge-TrainingData/BraTS-GLI-01497-000/BraTS-GLI-01497-000-t2f.nii.gz,../../DataSet/ASNR-MICCAI-BraTS2023-GLI-Challenge-TrainingData/BraTS-GLI-01497-000/BraTS-GLI-01497-000-t1n.nii.gz,../../DataSet/ASNR-MICCAI-BraTS2023-GLI-Challenge-TrainingData/BraTS-GLI-01497-000/BraTS-GLI-01497-000-seg.nii.gz,88,140,54,64,117,99,176,32,90,53,77,58
01330-000,../../DataSet/ASNR-MICCAI-BraTS2023-GLI-Challenge-TrainingData/BraTS-GLI-01330-000/BraTS-GLI-01330-000-t1c.nii.gz,../../DataSet/ASNR-MICCAI-BraTS2023-GLI-Challenge-TrainingData/BraTS-GLI-01330-000/BraTS-GLI-01330-000-t2w.nii.gz,../../DataSet/ASNR-MICCAI-BraTS2023-GLI-Challenge-TrainingData/BraTS-GLI-01330-000/BraTS-GLI-01330-000-t2f.nii.gz,../../DataSet/ASNR-MICCAI-BraTS2023-GLI-Challenge-TrainingData/BraTS-GLI-01330-000/BraTS-GLI-01330-000-t1n.nii.gz,../../DataSet/ASNR-MICCAI-BraTS2023-GLI-Challenge-TrainingData/BraTS-GLI-01330-000/BraTS-GLI-01330-000-seg.nii.gz,150,135,57,128,172,103,173,29,92,44,70,63
00035-000,../../DataSet/ASNR-MICCAI-BraTS2023-GLI-Challenge-TrainingData/BraTS-GLI-00035-000/BraTS-GLI-00035-000-t1c.nii.gz,../../DataSet/ASNR-MICCAI-BraTS2023-GLI-Challenge-TrainingData/BraTS-GLI-00035-000/BraTS-GLI-00035-000-t2w.nii.gz,../../DataSet/ASNR-MICCAI-BraTS2023-GLI-Challenge-TrainingData/BraTS-GLI-00035-000/BraTS-GLI-00035-000-t2f.nii.gz,../../DataSet/ASNR-MICCAI-BraTS2023-GLI-Challenge-TrainingData/BraTS-GLI-00035-000/BraTS-GLI-00035-000-t1n.nii.gz,../../DataSet/ASNR-MICCAI-BraTS2023-GLI-Challenge-TrainingData/BraTS-GLI-00035-000/BraTS-GLI-00035-000-seg.nii.gz,153,146,96,131,177,123,172,72,120,46,49,48
01214-000,../../DataSet/ASNR-MICCAI-BraTS2023-GLI-Challenge-TrainingData/BraTS-GLI-01214-000/BraTS-GLI-01214-000-t1c.nii.gz,../../DataSet/ASNR-MICCAI-BraTS2023-GLI-Challenge-TrainingData/BraTS-GLI-01214-000/BraTS-GLI-01214-000-t2w.nii.gz,../../DataSet/ASNR-MICCAI-BraTS2023-GLI-Challenge-TrainingData/BraTS-GLI-01214-000/BraTS-GLI-01214-000-t2f.nii.gz,../../DataSet/ASNR-MICCAI-BraTS2023-GLI-Challenge-TrainingData/BraTS-GLI-01214-000/BraTS-GLI-01214-000-t1n.nii.gz,../../DataSet/ASNR-MICCAI-BraTS2023-GLI-Challenge-TrainingData/BraTS-GLI-01214-000/BraTS-GLI-01214-000-seg.nii.gz,78,132,55,52,103,94,187,27,90,51,93,63
00485-000,../../DataSet/ASNR-MICCAI-BraTS2023-GLI-Challenge-TrainingData/BraTS-GLI-00485-000/BraTS-GLI-00485-000-t1c.nii.gz,../../DataSet/ASNR-MICCAI-BraTS2023-GLI-Challenge-TrainingData/BraTS-GLI-00485-000/BraTS-GLI-00485-000-t2w.nii.gz,../../DataSet/ASNR-MICCAI-BraTS2023-GLI-Challenge-TrainingData/BraTS-GLI-00485-000/BraTS-GLI-00485-000-t2f.nii.gz,../../DataSet/ASNR-MICCAI-BraTS2023-GLI-Challenge-TrainingData/BraTS-GLI-00485-000/BraTS-GLI-00485-000-t1n.nii.gz,../../DataSet/ASNR-MICCAI-BraTS2023-GLI-Challenge-TrainingData/BraTS-GLI-00485-000/BraTS-GLI-00485-000-seg.nii.gz,151,110,67,117,178,83,144,42,94,61,61,52
01103-000,../../DataSet/ASNR-MICCAI-BraTS2023-GLI-Challenge-TrainingData/BraTS-GLI-01103-000/BraTS-GLI-01103-000-t1c.nii.gz,../../DataSet/ASNR-MICCAI-BraTS2023-GLI-Challenge-TrainingData/BraTS-GLI-01103-000/BraTS-GLI-01103-000-t2w.nii.gz,../../DataSet/ASNR-MICCAI-BraTS2023-GLI-Challenge-TrainingData/BraTS-GLI-01103-000/BraTS-GLI-01103-000-t2f.nii.gz,../../DataSet/ASNR-MICCAI-BraTS2023-GLI-Challenge-TrainingData/BraTS-GLI-01103-000/BraTS-GLI-01103-000-t1n.nii.gz,../../DataSet/ASNR-MICCAI-BraTS2023-GLI-Challenge-TrainingData/BraTS-GLI-01103-000/BraTS-GLI-01103-000-seg.nii.gz,81,119,91,55,115,83,155,67,117,60,72,50
00795-000,../../DataSet/ASNR-MICCAI-BraTS2023-GLI-Challenge-TrainingData/BraTS-GLI-00795-000/BraTS-GLI-00795-000-t1c.nii.gz,../../DataSet/ASNR-MICCAI-BraTS2023-GLI-Challenge-TrainingData/BraTS-GLI-00795-000/BraTS-GLI-00795-000-t2w.nii.gz,../../DataSet/ASNR-MICCAI-BraTS2023-GLI-Challenge-TrainingData/BraTS-GLI-00795-000/BraTS-GLI-00795-000-t2f.nii.gz,../../DataSet/ASNR-MICCAI-BraTS2023-GLI-Challenge-TrainingData/BraTS-GLI-00795-000/BraTS-GLI-00795-000-t1n.nii.gz,../../DataSet/ASNR-MICCAI-BraTS2023-GLI-Challenge-TrainingData/BraTS-GLI-00795-000/BraTS-GLI-00795-000-seg.nii.gz,150,134,56,131,171,97,169,40,76,40,72,36
00032-000,../../DataSet/ASNR-MICCAI-BraTS2023-GLI-Challenge-TrainingData/BraTS-GLI-00032-000/BraTS-GLI-00032-000-t1c.nii.gz,../../DataSet/ASNR-MICCAI-BraTS2023-GLI-Challenge-TrainingData/BraTS-GLI-00032-000/BraTS-GLI-00032-000-t2w.nii.gz,../../DataSet/ASNR-MICCAI-BraTS2023-GLI-Challenge-TrainingData/BraTS-GLI-00032-000/BraTS-GLI-00032-000-t2f.nii.gz,../../DataSet/ASNR-MICCAI-BraTS2023-GLI-Challenge-TrainingData/BraTS-GLI-00032-000/BraTS-GLI-00032-000-t1n.nii.gz,../../DataSet/ASNR-MICCAI-BraTS2023-GLI-Challenge-TrainingData/BraTS-GLI-00032-000/BraTS-GLI-00032-000-seg.nii.gz,159,144,87,134,185,105,188,56,119,51,83,63
01213-000,../../DataSet/ASNR-MICCAI-BraTS2023-GLI-Challenge-TrainingData/BraTS-GLI-01213-000/BraTS-GLI-01213-000-t1c.nii.gz,../../DataSet/ASNR-MICCAI-BraTS2023-GLI-Challenge-TrainingData/BraTS-GLI-01213-000/BraTS-GLI-01213-000-t2w.nii.gz,../../DataSet/ASNR-MICCAI-BraTS2023-GLI-Challenge-TrainingData/BraTS-GLI-01213-000/BraTS-GLI-01213-000-t2f.nii.gz,../../DataSet/ASNR-MICCAI-BraTS2023-GLI-Challenge-TrainingData/BraTS-GLI-01213-000/BraTS-GLI-01213-000-t1n.nii.gz,../../DataSet/ASNR-MICCAI-BraTS2023-GLI-Challenge-TrainingData/BraTS-GLI-01213-000/BraTS-GLI-01213-000-seg.nii.gz,137,151,87,100,163,100,181,56,117,63,81,61
00453-000,../../DataSet/ASNR-MICCAI-BraTS2023-GLI-Challenge-TrainingData/BraTS-GLI-00453-000/BraTS-GLI-00453-000-t1c.nii.gz,../../DataSet/ASNR-MICCAI-BraTS2023-GLI-Challenge-TrainingData/BraTS-GLI-00453-000/BraTS-GLI-00453-000-t2w.nii.gz,../../DataSet/ASNR-MICCAI-BraTS2023-GLI-Challenge-TrainingData/BraTS-GLI-00453-000/BraTS-GLI-00453-000-t2f.nii.gz,../../DataSet/ASNR-MICCAI-BraTS2023-GLI-Challenge-TrainingData/BraTS-GLI-00453-000/BraTS-GLI-00453-000-t1n.nii.gz,../../DataSet/ASNR-MICCAI-BraTS2023-GLI-Challenge-TrainingData/BraTS-GLI-00453-000/BraTS-GLI-00453-000-seg.nii.gz,143,160,102,123,172,130,192,67,134,49,62,67
00500-001,../../DataSet/ASNR-MICCAI-BraTS2023-GLI-Challenge-TrainingData/BraTS-GLI-00500-001/BraTS-GLI-00500-001-t1c.nii.gz,../../DataSet/ASNR-MICCAI-BraTS2023-GLI-Challenge-TrainingData/BraTS-GLI-00500-001/BraTS-GLI-00500-001-t2w.nii.gz,../../DataSet/ASNR-MICCAI-BraTS2023-GLI-Challenge-TrainingData/BraTS-GLI-00500-001/BraTS-GLI-00500-001-t2f.nii.gz,../../DataSet/ASNR-MICCAI-BraTS2023-GLI-Challenge-TrainingData/BraTS-GLI-00500-001/BraTS-GLI-00500-001-t1n.nii.gz,../../DataSet/ASNR-MICCAI-BraTS2023-GLI-Challenge-TrainingData/BraTS-GLI-00500-001/BraTS-GLI-00500-001-seg.nii.gz,157,110,87,137,178,75,139,57,122,41,64,65
00325-000,../../DataSet/ASNR-MICCAI-BraTS2023-GLI-Challenge-TrainingData/BraTS-GLI-00325-000/BraTS-GLI-00325-000-t1c.nii.gz,../../DataSet/ASNR-MICCAI-BraTS2023-GLI-Challenge-TrainingData/BraTS-GLI-00325-000/BraTS-GLI-00325-000-t2w.nii.gz,../../DataSet/ASNR-MICCAI-BraTS2023-GLI-Challenge-TrainingData/BraTS-GLI-00325-000/BraTS-GLI-00325-000-t2f.nii.gz,../../DataSet/ASNR-MICCAI-BraTS2023-GLI-Challenge-TrainingData/BraTS-GLI-00325-000/BraTS-GLI-00325-000-t1n.nii.gz,../../DataSet/ASNR-MICCAI-BraTS2023-GLI-Challenge-TrainingData/BraTS-GLI-00325-000/BraTS-GLI-00325-000-seg.nii.gz,90,148,86,55,133,104,193,52,130,78,89,78
00744-000,../../DataSet/ASNR-MICCAI-BraTS2023-GLI-Challenge-TrainingData/BraTS-GLI-00744-000/BraTS-GLI-00744-000-t1c.nii.gz,../../DataSet/ASNR-MICCAI-BraTS2023-GLI-Challenge-TrainingData/BraTS-GLI-00744-000/BraTS-GLI-00744-000-t2w.nii.gz,../../DataSet/ASNR-MICCAI-BraTS2023-GLI-Challenge-TrainingData/BraTS-GLI-00744-000/BraTS-GLI-00744-000-t2f.nii.gz,../../DataSet/ASNR-MICCAI-BraTS2023-GLI-Challenge-TrainingData/BraTS-GLI-00744-000/BraTS-GLI-00744-000-t1n.nii.gz,../../DataSet/ASNR-MICCAI-BraTS2023-GLI-Challenge-TrainingData/BraTS-GLI-00744-000/BraTS-GLI-00744-000-seg.nii.gz,150,115,100,121,182,85,148,74,134,61,63,60
00359-000,../../DataSet/ASNR-MICCAI-BraTS2023-GLI-Challenge-TrainingData/BraTS-GLI-00359-000/BraTS-GLI-00359-000-t1c.nii.gz,../../DataSet/ASNR-MICCAI-BraTS2023-GLI-Challenge-TrainingData/BraTS-GLI-00359-000/BraTS-GLI-00359-000-t2w.nii.gz,../../DataSet/ASNR-MICCAI-BraTS2023-GLI-Challenge-TrainingData/BraTS-GLI-00359-000/BraTS-GLI-00359-000-t2f.nii.gz,../../DataSet/ASNR-MICCAI-BraTS2023-GLI-Challenge-TrainingData/BraTS-GLI-00359-000/BraTS-GLI-00359-000-t1n.nii.gz,../../DataSet/ASNR-MICCAI-BraTS2023-GLI-Challenge-TrainingData/BraTS-GLI-00359-000/BraTS-GLI-00359-000-seg.nii.gz,80,151,89,55,106,115,189,57,127,51,74,70
01519-000,../../DataSet/ASNR-MICCAI-BraTS2023-GLI-Challenge-TrainingData/BraTS-GLI-01519-000/BraTS-GLI-01519-000-t1c.nii.gz,../../DataSet/ASNR-MICCAI-BraTS2023-GLI-Challenge-TrainingData/BraTS-GLI-01519-000/BraTS-GLI-01519-000-t2w.nii.gz,../../DataSet/ASNR-MICCAI-BraTS2023-GLI-Challenge-TrainingData/BraTS-GLI-01519-000/BraTS-GLI-01519-000-t2f.nii.gz,../../DataSet/ASNR-MICCAI-BraTS2023-GLI-Challenge-TrainingData/BraTS-GLI-01519-000/BraTS-GLI-01519-000-t1n.nii.gz,../../DataSet/ASNR-MICCAI-BraTS2023-GLI-Challenge-TrainingData/BraTS-GLI-01519-000/BraTS-GLI-01519-000-seg.nii.gz,148,187,83,125,176,159,209,57,108,51,50,51
01178-000,../../DataSet/ASNR-MICCAI-BraTS2023-GLI-Challenge-TrainingData/BraTS-GLI-01178-000/BraTS-GLI-01178-000-t1c.nii.gz,../../DataSet/ASNR-MICCAI-BraTS2023-GLI-Challenge-TrainingData/BraTS-GLI-01178-000/BraTS-GLI-01178-000-t2w.nii.gz,../../DataSet/ASNR-MICCAI-BraTS2023-GLI-Challenge-TrainingData/BraTS-GLI-01178-000/BraTS-GLI-01178-000-t2f.nii.gz,../../DataSet/ASNR-MICCAI-BraTS2023-GLI-Challenge-TrainingData/BraTS-GLI-01178-000/BraTS-GLI-01178-000-t1n.nii.gz,../../DataSet/ASNR-MICCAI-BraTS2023-GLI-Challenge-TrainingData/BraTS-GLI-01178-000/BraTS-GLI-01178-000-seg.nii.gz,101,145,115,81,120,118,169,88,138,39,51,50
00201-000,../../DataSet/ASNR-MICCAI-BraTS2023-GLI-Challenge-TrainingData/BraTS-GLI-00201-000/BraTS-GLI-00201-000-t1c.nii.gz,../../DataSet/ASNR-MICCAI-BraTS2023-GLI-Challenge-TrainingData/BraTS-GLI-00201-000/BraTS-GLI-00201-000-t2w.nii.gz,../../DataSet/ASNR-MICCAI-BraTS2023-GLI-Challenge-TrainingData/BraTS-GLI-00201-000/BraTS-GLI-00201-000-t2f.nii.gz,../../DataSet/ASNR-MICCAI-BraTS2023-GLI-Challenge-TrainingData/BraTS-GLI-00201-000/BraTS-GLI-00201-000-t1n.nii.gz,../../DataSet/ASNR-MICCAI-BraTS2023-GLI-Challenge-TrainingData/BraTS-GLI-00201-000/BraTS-GLI-00201-000-seg.nii.gz,143,165,96,117,178,125,206,60,137,61,81,77
01441-000,../../DataSet/ASNR-MICCAI-BraTS2023-GLI-Challenge-TrainingData/BraTS-GLI-01441-000/BraTS-GLI-01441-000-t1c.nii.gz,../../DataSet/ASNR-MICCAI-BraTS2023-GLI-Challenge-TrainingData/BraTS-GLI-01441-000/BraTS-GLI-01441-000-t2w.nii.gz,../../DataSet/ASNR-MICCAI-BraTS2023-GLI-Challenge-TrainingData/BraTS-GLI-01441-000/BraTS-GLI-01441-000-t2f.nii.gz,../../DataSet/ASNR-MICCAI-BraTS2023-GLI-Challenge-TrainingData/BraTS-GLI-01441-000/BraTS-GLI-01441-000-t1n.nii.gz,../../DataSet/ASNR-MICCAI-BraTS2023-GLI-Challenge-TrainingData/BraTS-GLI-01441-000/BraTS-GLI-01441-000-seg.nii.gz,91,98,95,62,123,59,135,65,132,61,76,67
01020-000,../../DataSet/ASNR-MICCAI-BraTS2023-GLI-Challenge-TrainingData/BraTS-GLI-01020-000/BraTS-GLI-01020-000-t1c.nii.gz,../../DataSet/ASNR-MICCAI-BraTS2023-GLI-Challenge-TrainingData/BraTS-GLI-01020-000/BraTS-GLI-01020-000-t2w.nii.gz,../../DataSet/ASNR-MICCAI-BraTS2023-GLI-Challenge-TrainingData/BraTS-GLI-01020-000/BraTS-GLI-01020-000-t2f.nii.gz,../../DataSet/ASNR-MICCAI-BraTS2023-GLI-Challenge-TrainingData/BraTS-GLI-01020-000/BraTS-GLI-01020-000-t1n.nii.gz,../../DataSet/ASNR-MICCAI-BraTS2023-GLI-Challenge-TrainingData/BraTS-GLI-01020-000/BraTS-GLI-01020-000-seg.nii.gz,159,125,63,122,190,82,172,30,96,68,90,66
00116-000,../../DataSet/ASNR-MICCAI-BraTS2023-GLI-Challenge-TrainingData/BraTS-GLI-00116-000/BraTS-GLI-00116-000-t1c.nii.gz,../../DataSet/ASNR-MICCAI-BraTS2023-GLI-Challenge-TrainingData/BraTS-GLI-00116-000/BraTS-GLI-00116-000-t2w.nii.gz,../../DataSet/ASNR-MICCAI-BraTS2023-GLI-Challenge-TrainingData/BraTS-GLI-00116-000/BraTS-GLI-00116-000-t2f.nii.gz,../../DataSet/ASNR-MICCAI-BraTS2023-GLI-Challenge-TrainingData/BraTS-GLI-00116-000/BraTS-GLI-00116-000-t1n.nii.gz,../../DataSet/ASNR-MICCAI-BraTS2023-GLI-Challenge-TrainingData/BraTS-GLI-00116-000/BraTS-GLI-00116-000-seg.nii.gz,90,160,73,60,124,114,202,30,123,64,88,93
00733-001,../../DataSet/ASNR-MICCAI-BraTS2023-GLI-Challenge-TrainingData/BraTS-GLI-00733-001/BraTS-GLI-00733-001-t1c.nii.gz,../../DataSet/ASNR-MICCAI-BraTS2023-GLI-Challenge-TrainingData/BraTS-GLI-00733-001/BraTS-GLI-00733-001-t2w.nii.gz,../../DataSet/ASNR-MICCAI-BraTS2023-GLI-Challenge-TrainingData/BraTS-GLI-00733-001/BraTS-GLI-00733-001-t2f.nii.gz,../../DataSet/ASNR-MICCAI-BraTS2023-GLI-Challenge-TrainingData/BraTS-GLI-00733-001/BraTS-GLI-00733-001-t1n.nii.gz,../../DataSet/ASNR-MICCAI-BraTS2023-GLI-Challenge-TrainingData/BraTS-GLI-00733-001/BraTS-GLI-00733-001-seg.nii.gz,73,161,73,62,84,151,174,56,92,22,23,36
01337-000,../../DataSet/ASNR-MICCAI-BraTS2023-GLI-Challenge-TrainingData/BraTS-GLI-01337-000/BraTS-GLI-01337-000-t1c.nii.gz,../../DataSet/ASNR-MICCAI-BraTS2023-GLI-Challenge-TrainingData/BraTS-GLI-01337-000/BraTS-GLI-01337-000-t2w.nii.gz,../../DataSet/ASNR-MICCAI-BraTS2023-GLI-Challenge-TrainingData/BraTS-GLI-01337-000/BraTS-GLI-01337-000-t2f.nii.gz,../../DataSet/ASNR-MICCAI-BraTS2023-GLI-Challenge-TrainingData/BraTS-GLI-01337-000/BraTS-GLI-01337-000-t1n.nii.gz,../../DataSet/ASNR-MICCAI-BraTS2023-GLI-Challenge-TrainingData/BraTS-GLI-01337-000/BraTS-GLI-01337-000-seg.nii.gz,141,176,74,120,172,149,209,40,119,52,60,79
01490-000,../../DataSet/ASNR-MICCAI-BraTS2023-GLI-Challenge-TrainingData/BraTS-GLI-01490-000/BraTS-GLI-01490-000-t1c.nii.gz,../../DataSet/ASNR-MICCAI-BraTS2023-GLI-Challenge-TrainingData/BraTS-GLI-01490-000/BraTS-GLI-01490-000-t2w.nii.gz,../../DataSet/ASNR-MICCAI-BraTS2023-GLI-Challenge-TrainingData/BraTS-GLI-01490-000/BraTS-GLI-01490-000-t2f.nii.gz,../../DataSet/ASNR-MICCAI-BraTS2023-GLI-Challenge-TrainingData/BraTS-GLI-01490-000/BraTS-GLI-01490-000-t1n.nii.gz,../../DataSet/ASNR-MICCAI-BraTS2023-GLI-Challenge-TrainingData/BraTS-GLI-01490-000/BraTS-GLI-01490-000-seg.nii.gz,137,96,93,104,168,57,147,59,123,64,90,64
00577-000,../../DataSet/ASNR-MICCAI-BraTS2023-GLI-Challenge-TrainingData/BraTS-GLI-00577-000/BraTS-GLI-00577-000-t1c.nii.gz,../../DataSet/ASNR-MICCAI-BraTS2023-GLI-Challenge-TrainingData/BraTS-GLI-00577-000/BraTS-GLI-00577-000-t2w.nii.gz,../../DataSet/ASNR-MICCAI-BraTS2023-GLI-Challenge-TrainingData/BraTS-GLI-00577-000/BraTS-GLI-00577-000-t2f.nii.gz,../../DataSet/ASNR-MICCAI-BraTS2023-GLI-Challenge-TrainingData/BraTS-GLI-00577-000/BraTS-GLI-00577-000-t1n.nii.gz,../../DataSet/ASNR-MICCAI-BraTS2023-GLI-Challenge-TrainingData/BraTS-GLI-00577-000/BraTS-GLI-00577-000-seg.nii.gz,96,165,96,68,125,131,202,55,135,57,71,80
01433-000,../../DataSet/ASNR-MICCAI-BraTS2023-GLI-Challenge-TrainingData/BraTS-GLI-01433-000/BraTS-GLI-01433-000-t1c.nii.gz,../../DataSet/ASNR-MICCAI-BraTS2023-GLI-Challenge-TrainingData/BraTS-GLI-01433-000/BraTS-GLI-01433-000-t2w.nii.gz,../../DataSet/ASNR-MICCAI-BraTS2023-GLI-Challenge-TrainingData/BraTS-GLI-01433-000/BraTS-GLI-01433-000-t2f.nii.gz,../../DataSet/ASNR-MICCAI-BraTS2023-GLI-Challenge-TrainingData/BraTS-GLI-01433-000/BraTS-GLI-01433-000-t1n.nii.gz,../../DataSet/ASNR-MICCAI-BraTS2023-GLI-Challenge-TrainingData/BraTS-GLI-01433-000/BraTS-GLI-01433-000-seg.nii.gz,160,135,78,135,186,97,175,49,105,51,78,56
01394-000,../../DataSet/ASNR-MICCAI-BraTS2023-GLI-Challenge-TrainingData/BraTS-GLI-01394-000/BraTS-GLI-01394-000-t1c.nii.gz,../../DataSet/ASNR-MICCAI-BraTS2023-GLI-Challenge-TrainingData/BraTS-GLI-01394-000/BraTS-GLI-01394-000-t2w.nii.gz,../../DataSet/ASNR-MICCAI-BraTS2023-GLI-Challenge-TrainingData/BraTS-GLI-01394-000/BraTS-GLI-01394-000-t2f.nii.gz,../../DataSet/ASNR-MICCAI-BraTS2023-GLI-Challenge-TrainingData/BraTS-GLI-01394-000/BraTS-GLI-01394-000-t1n.nii.gz,../../DataSet/ASNR-MICCAI-BraTS2023-GLI-Challenge-TrainingData/BraTS-GLI-01394-000/BraTS-GLI-01394-000-seg.nii.gz,160,164,65,137,183,126,196,33,95,46,70,62
00273-000,../../DataSet/ASNR-MICCAI-BraTS2023-GLI-Challenge-TrainingData/BraTS-GLI-00273-000/BraTS-GLI-00273-000-t1c.nii.gz,../../DataSet/ASNR-MICCAI-BraTS2023-GLI-Challenge-TrainingData/BraTS-GLI-00273-000/BraTS-GLI-00273-000-t2w.nii.gz,../../DataSet/ASNR-MICCAI-BraTS2023-GLI-Challenge-TrainingData/BraTS-GLI-00273-000/BraTS-GLI-00273-000-t2f.nii.gz,../../DataSet/ASNR-MICCAI-BraTS2023-GLI-Challenge-TrainingData/BraTS-GLI-00273-000/BraTS-GLI-00273-000-t1n.nii.gz,../../DataSet/ASNR-MICCAI-BraTS2023-GLI-Challenge-TrainingData/BraTS-GLI-00273-000/BraTS-GLI-00273-000-seg.nii.gz,156,122,68,124,183,87,166,35,98,59,79,63
01052-000,../../DataSet/ASNR-MICCAI-BraTS2023-GLI-Challenge-TrainingData/BraTS-GLI-01052-000/BraTS-GLI-01052-000-t1c.nii.gz,../../DataSet/ASNR-MICCAI-BraTS2023-GLI-Challenge-TrainingData/BraTS-GLI-01052-000/BraTS-GLI-01052-000-t2w.nii.gz,../../DataSet/ASNR-MICCAI-BraTS2023-GLI-Challenge-TrainingData/BraTS-GLI-01052-000/BraTS-GLI-01052-000-t2f.nii.gz,../../DataSet/ASNR-MICCAI-BraTS2023-GLI-Challenge-TrainingData/BraTS-GLI-01052-000/BraTS-GLI-01052-000-t1n.nii.gz,../../DataSet/ASNR-MICCAI-BraTS2023-GLI-Challenge-TrainingData/BraTS-GLI-01052-000/BraTS-GLI-01052-000-seg.nii.gz,127,92,90,90,160,49,142,66,119,70,93,53
01083-000,../../DataSet/ASNR-MICCAI-BraTS2023-GLI-Challenge-TrainingData/BraTS-GLI-01083-000/BraTS-GLI-01083-000-t1c.nii.gz,../../DataSet/ASNR-MICCAI-BraTS2023-GLI-Challenge-TrainingData/BraTS-GLI-01083-000/BraTS-GLI-01083-000-t2w.nii.gz,../../DataSet/ASNR-MICCAI-BraTS2023-GLI-Challenge-TrainingData/BraTS-GLI-01083-000/BraTS-GLI-01083-000-t2f.nii.gz,../../DataSet/ASNR-MICCAI-BraTS2023-GLI-Challenge-TrainingData/BraTS-GLI-01083-000/BraTS-GLI-01083-000-t1n.nii.gz,../../DataSet/ASNR-MICCAI-BraTS2023-GLI-Challenge-TrainingData/BraTS-GLI-01083-000/BraTS-GLI-01083-000-seg.nii.gz,84,138,95,56,110,93,177,64,135,54,84,71
00505-000,../../DataSet/ASNR-MICCAI-BraTS2023-GLI-Challenge-TrainingData/BraTS-GLI-00505-000/BraTS-GLI-00505-000-t1c.nii.gz,../../DataSet/ASNR-MICCAI-BraTS2023-GLI-Challenge-TrainingData/BraTS-GLI-00505-000/BraTS-GLI-00505-000-t2w.nii.gz,../../DataSet/ASNR-MICCAI-BraTS2023-GLI-Challenge-TrainingData/BraTS-GLI-00505-000/BraTS-GLI-00505-000-t2f.nii.gz,../../DataSet/ASNR-MICCAI-BraTS2023-GLI-Challenge-TrainingData/BraTS-GLI-00505-000/BraTS-GLI-00505-000-t1n.nii.gz,../../DataSet/ASNR-MICCAI-BraTS2023-GLI-Challenge-TrainingData/BraTS-GLI-00505-000/BraTS-GLI-00505-000-seg.nii.gz,165,141,73,140,189,103,178,44,111,49,75,67
01345-000,../../DataSet/ASNR-MICCAI-BraTS2023-GLI-Challenge-TrainingData/BraTS-GLI-01345-000/BraTS-GLI-01345-000-t1c.nii.gz,../../DataSet/ASNR-MICCAI-BraTS2023-GLI-Challenge-TrainingData/BraTS-GLI-01345-000/BraTS-GLI-01345-000-t2w.nii.gz,../../DataSet/ASNR-MICCAI-BraTS2023-GLI-Challenge-TrainingData/BraTS-GLI-01345-000/BraTS-GLI-01345-000-t2f.nii.gz,../../DataSet/ASNR-MICCAI-BraTS2023-GLI-Challenge-TrainingData/BraTS-GLI-01345-000/BraTS-GLI-01345-000-t1n.nii.gz,../../DataSet/ASNR-MICCAI-BraTS2023-GLI-Challenge-TrainingData/BraTS-GLI-01345-000/BraTS-GLI-01345-000-seg.nii.gz,150,135,67,93,179,100,179,39,114,86,79,75
00421-000,../../DataSet/ASNR-MICCAI-BraTS2023-GLI-Challenge-TrainingData/BraTS-GLI-00421-000/BraTS-GLI-00421-000-t1c.nii.gz,../../DataSet/ASNR-MICCAI-BraTS2023-GLI-Challenge-TrainingData/BraTS-GLI-00421-000/BraTS-GLI-00421-000-t2w.nii.gz,../../DataSet/ASNR-MICCAI-BraTS2023-GLI-Challenge-TrainingData/BraTS-GLI-00421-000/BraTS-GLI-00421-000-t2f.nii.gz,../../DataSet/ASNR-MICCAI-BraTS2023-GLI-Challenge-TrainingData/BraTS-GLI-00421-000/BraTS-GLI-00421-000-t1n.nii.gz,../../DataSet/ASNR-MICCAI-BraTS2023-GLI-Challenge-TrainingData/BraTS-GLI-00421-000/BraTS-GLI-00421-000-seg.nii.gz,95,158,100,58,122,123,204,64,138,64,81,74
00386-000,../../DataSet/ASNR-MICCAI-BraTS2023-GLI-Challenge-TrainingData/BraTS-GLI-00386-000/BraTS-GLI-00386-000-t1c.nii.gz,../../DataSet/ASNR-MICCAI-BraTS2023-GLI-Challenge-TrainingData/BraTS-GLI-00386-000/BraTS-GLI-00386-000-t2w.nii.gz,../../DataSet/ASNR-MICCAI-BraTS2023-GLI-Challenge-TrainingData/BraTS-GLI-00386-000/BraTS-GLI-00386-000-t2f.nii.gz,../../DataSet/ASNR-MICCAI-BraTS2023-GLI-Challenge-TrainingData/BraTS-GLI-00386-000/BraTS-GLI-00386-000-t1n.nii.gz,../../DataSet/ASNR-MICCAI-BraTS2023-GLI-Challenge-TrainingData/BraTS-GLI-00386-000/BraTS-GLI-00386-000-seg.nii.gz,161,118,64,138,186,82,160,39,88,48,78,49
01261-000,../../DataSet/ASNR-MICCAI-BraTS2023-GLI-Challenge-TrainingData/BraTS-GLI-01261-000/BraTS-GLI-01261-000-t1c.nii.gz,../../DataSet/ASNR-MICCAI-BraTS2023-GLI-Challenge-TrainingData/BraTS-GLI-01261-000/BraTS-GLI-01261-000-t2w.nii.gz,../../DataSet/ASNR-MICCAI-BraTS2023-GLI-Challenge-TrainingData/BraTS-GLI-01261-000/BraTS-GLI-01261-000-t2f.nii.gz,../../DataSet/ASNR-MICCAI-BraTS2023-GLI-Challenge-TrainingData/BraTS-GLI-01261-000/BraTS-GLI-01261-000-t1n.nii.gz,../../DataSet/ASNR-MICCAI-BraTS2023-GLI-Challenge-TrainingData/BraTS-GLI-01261-000/BraTS-GLI-01261-000-seg.nii.gz,138,163,76,102,164,127,201,53,102,62,74,49
01517-000,../../DataSet/ASNR-MICCAI-BraTS2023-GLI-Challenge-TrainingData/BraTS-GLI-01517-000/BraTS-GLI-01517-000-t1c.nii.gz,../../DataSet/ASNR-MICCAI-BraTS2023-GLI-Challenge-TrainingData/BraTS-GLI-01517-000/BraTS-GLI-01517-000-t2w.nii.gz,../../DataSet/ASNR-MICCAI-BraTS2023-GLI-Challenge-TrainingData/BraTS-GLI-01517-000/BraTS-GLI-01517-000-t2f.nii.gz,../../DataSet/ASNR-MICCAI-BraTS2023-GLI-Challenge-TrainingData/BraTS-GLI-01517-000/BraTS-GLI-01517-000-t1n.nii.gz,../../DataSet/ASNR-MICCAI-BraTS2023-GLI-Challenge-TrainingData/BraTS-GLI-01517-000/BraTS-GLI-01517-000-seg.nii.gz,125,93,87,89,158,51,143,46,130,69,92,84
00736-000,../../DataSet/ASNR-MICCAI-BraTS2023-GLI-Challenge-TrainingData/BraTS-GLI-00736-000/BraTS-GLI-00736-000-t1c.nii.gz,../../DataSet/ASNR-MICCAI-BraTS2023-GLI-Challenge-TrainingData/BraTS-GLI-00736-000/BraTS-GLI-00736-000-t2w.nii.gz,../../DataSet/ASNR-MICCAI-BraTS2023-GLI-Challenge-TrainingData/BraTS-GLI-00736-000/BraTS-GLI-00736-000-t2f.nii.gz,../../DataSet/ASNR-MICCAI-BraTS2023-GLI-Challenge-TrainingData/BraTS-GLI-00736-000/BraTS-GLI-00736-000-t1n.nii.gz,../../DataSet/ASNR-MICCAI-BraTS2023-GLI-Challenge-TrainingData/BraTS-GLI-00736-000/BraTS-GLI-00736-000-seg.nii.gz,90,111,106,64,117,81,146,70,137,53,65,67
01176-000,../../DataSet/ASNR-MICCAI-BraTS2023-GLI-Challenge-TrainingData/BraTS-GLI-01176-000/BraTS-GLI-01176-000-t1c.nii.gz,../../DataSet/ASNR-MICCAI-BraTS2023-GLI-Challenge-TrainingData/BraTS-GLI-01176-000/BraTS-GLI-01176-000-t2w.nii.gz,../../DataSet/ASNR-MICCAI-BraTS2023-GLI-Challenge-TrainingData/BraTS-GLI-01176-000/BraTS-GLI-01176-000-t2f.nii.gz,../../DataSet/ASNR-MICCAI-BraTS2023-GLI-Challenge-TrainingData/BraTS-GLI-01176-000/BraTS-GLI-01176-000-t1n.nii.gz,../../DataSet/ASNR-MICCAI-BraTS2023-GLI-Challenge-TrainingData/BraTS-GLI-01176-000/BraTS-GLI-01176-000-seg.nii.gz,130,86,104,109,163,54,122,73,133,54,68,60
00579-000,../../DataSet/ASNR-MICCAI-BraTS2023-GLI-Challenge-TrainingData/BraTS-GLI-00579-000/BraTS-GLI-00579-000-t1c.nii.gz,../../DataSet/ASNR-MICCAI-BraTS2023-GLI-Challenge-TrainingData/BraTS-GLI-00579-000/BraTS-GLI-00579-000-t2w.nii.gz,../../DataSet/ASNR-MICCAI-BraTS2023-GLI-Challenge-TrainingData/BraTS-GLI-00579-000/BraTS-GLI-00579-000-t2f.nii.gz,../../DataSet/ASNR-MICCAI-BraTS2023-GLI-Challenge-TrainingData/BraTS-GLI-00579-000/BraTS-GLI-00579-000-t1n.nii.gz,../../DataSet/ASNR-MICCAI-BraTS2023-GLI-Challenge-TrainingData/BraTS-GLI-00579-000/BraTS-GLI-00579-000-seg.nii.gz,97,164,87,71,130,135,199,48,130,59,64,82
01339-000,../../DataSet/ASNR-MICCAI-BraTS2023-GLI-Challenge-TrainingData/BraTS-GLI-01339-000/BraTS-GLI-01339-000-t1c.nii.gz,../../DataSet/ASNR-MICCAI-BraTS2023-GLI-Challenge-TrainingData/BraTS-GLI-01339-000/BraTS-GLI-01339-000-t2w.nii.gz,../../DataSet/ASNR-MICCAI-BraTS2023-GLI-Challenge-TrainingData/BraTS-GLI-01339-000/BraTS-GLI-01339-000-t2f.nii.gz,../../DataSet/ASNR-MICCAI-BraTS2023-GLI-Challenge-TrainingData/BraTS-GLI-01339-000/BraTS-GLI-01339-000-t1n.nii.gz,../../DataSet/ASNR-MICCAI-BraTS2023-GLI-Challenge-TrainingData/BraTS-GLI-01339-000/BraTS-GLI-01339-000-seg.nii.gz,93,163,92,60,127,128,204,53,136,67,76,83
00350-000,../../DataSet/ASNR-MICCAI-BraTS2023-GLI-Challenge-TrainingData/BraTS-GLI-00350-000/BraTS-GLI-00350-000-t1c.nii.gz,../../DataSet/ASNR-MICCAI-BraTS2023-GLI-Challenge-TrainingData/BraTS-GLI-00350-000/BraTS-GLI-00350-000-t2w.nii.gz,../../DataSet/ASNR-MICCAI-BraTS2023-GLI-Challenge-TrainingData/BraTS-GLI-00350-000/BraTS-GLI-00350-000-t2f.nii.gz,../../DataSet/ASNR-MICCAI-BraTS2023-GLI-Challenge-TrainingData/BraTS-GLI-00350-000/BraTS-GLI-00350-000-t1n.nii.gz,../../DataSet/ASNR-MICCAI-BraTS2023-GLI-Challenge-TrainingData/BraTS-GLI-00350-000/BraTS-GLI-00350-000-seg.nii.gz,104,84,103,82,124,50,115,78,131,42,65,53
01171-000,../../DataSet/ASNR-MICCAI-BraTS2023-GLI-Challenge-TrainingData/BraTS-GLI-01171-000/BraTS-GLI-01171-000-t1c.nii.gz,../../DataSet/ASNR-MICCAI-BraTS2023-GLI-Challenge-TrainingData/BraTS-GLI-01171-000/BraTS-GLI-01171-000-t2w.nii.gz,../../DataSet/ASNR-MICCAI-BraTS2023-GLI-Challenge-TrainingData/BraTS-GLI-01171-000/BraTS-GLI-01171-000-t2f.nii.gz,../../DataSet/ASNR-MICCAI-BraTS2023-GLI-Challenge-TrainingData/BraTS-GLI-01171-000/BraTS-GLI-01171-000-t1n.nii.gz,../../DataSet/ASNR-MICCAI-BraTS2023-GLI-Challenge-TrainingData/BraTS-GLI-01171-000/BraTS-GLI-01171-000-seg.nii.gz,83,125,63,53,119,82,177,31,100,66,95,69
00731-000,../../DataSet/ASNR-MICCAI-BraTS2023-GLI-Challenge-TrainingData/BraTS-GLI-00731-000/BraTS-GLI-00731-000-t1c.nii.gz,../../DataSet/ASNR-MICCAI-BraTS2023-GLI-Challenge-TrainingData/BraTS-GLI-00731-000/BraTS-GLI-00731-000-t2w.nii.gz,../../DataSet/ASNR-MICCAI-BraTS2023-GLI-Challenge-TrainingData/BraTS-GLI-00731-000/BraTS-GLI-00731-000-t2f.nii.gz,../../DataSet/ASNR-MICCAI-BraTS2023-GLI-Challenge-TrainingData/BraTS-GLI-00731-000/BraTS-GLI-00731-000-t1n.nii.gz,../../DataSet/ASNR-MICCAI-BraTS2023-GLI-Challenge-TrainingData/BraTS-GLI-00731-000/BraTS-GLI-00731-000-seg.nii.gz,70,122,65,56,87,102,147,52,77,31,45,25
00096-000,../../DataSet/ASNR-MICCAI-BraTS2023-GLI-Challenge-TrainingData/BraTS-GLI-00096-000/BraTS-GLI-00096-000-t1c.nii.gz,../../DataSet/ASNR-MICCAI-BraTS2023-GLI-Challenge-TrainingData/BraTS-GLI-00096-000/BraTS-GLI-00096-000-t2w.nii.gz,../../DataSet/ASNR-MICCAI-BraTS2023-GLI-Challenge-TrainingData/BraTS-GLI-00096-000/BraTS-GLI-00096-000-t2f.nii.gz,../../DataSet/ASNR-MICCAI-BraTS2023-GLI-Challenge-TrainingData/BraTS-GLI-00096-000/BraTS-GLI-00096-000-t1n.nii.gz,../../DataSet/ASNR-MICCAI-BraTS2023-GLI-Challenge-TrainingData/BraTS-GLI-00096-000/BraTS-GLI-00096-000-seg.nii.gz,78,145,70,52,106,100,184,42,108,54,84,66
01448-000,../../DataSet/ASNR-MICCAI-BraTS2023-GLI-Challenge-TrainingData/BraTS-GLI-01448-000/BraTS-GLI-01448-000-t1c.nii.gz,../../DataSet/ASNR-MICCAI-BraTS2023-GLI-Challenge-TrainingData/BraTS-GLI-01448-000/BraTS-GLI-01448-000-t2w.nii.gz,../../DataSet/ASNR-MICCAI-BraTS2023-GLI-Challenge-TrainingData/BraTS-GLI-01448-000/BraTS-GLI-01448-000-t2f.nii.gz,../../DataSet/ASNR-MICCAI-BraTS2023-GLI-Challenge-TrainingData/BraTS-GLI-01448-000/BraTS-GLI-01448-000-t1n.nii.gz,../../DataSet/ASNR-MICCAI-BraTS2023-GLI-Challenge-TrainingData/BraTS-GLI-01448-000/BraTS-GLI-01448-000-seg.nii.gz,82,106,56,59,106,84,133,33,86,47,49,53
01029-000,../../DataSet/ASNR-MICCAI-BraTS2023-GLI-Challenge-TrainingData/BraTS-GLI-01029-000/BraTS-GLI-01029-000-t1c.nii.gz,../../DataSet/ASNR-MICCAI-BraTS2023-GLI-Challenge-TrainingData/BraTS-GLI-01029-000/BraTS-GLI-01029-000-t2w.nii.gz,../../DataSet/ASNR-MICCAI-BraTS2023-GLI-Challenge-TrainingData/BraTS-GLI-01029-000/BraTS-GLI-01029-000-t2f.nii.gz,../../DataSet/ASNR-MICCAI-BraTS2023-GLI-Challenge-TrainingData/BraTS-GLI-01029-000/BraTS-GLI-01029-000-t1n.nii.gz,../../DataSet/ASNR-MICCAI-BraTS2023-GLI-Challenge-TrainingData/BraTS-GLI-01029-000/BraTS-GLI-01029-000-seg.nii.gz,138,78,84,108,173,41,110,51,129,65,69,78
01499-000,../../DataSet/ASNR-MICCAI-BraTS2023-GLI-Challenge-TrainingData/BraTS-GLI-01499-000/BraTS-GLI-01499-000-t1c.nii.gz,../../DataSet/ASNR-MICCAI-BraTS2023-GLI-Challenge-TrainingData/BraTS-GLI-01499-000/BraTS-GLI-01499-000-t2w.nii.gz,../../DataSet/ASNR-MICCAI-BraTS2023-GLI-Challenge-TrainingData/BraTS-GLI-01499-000/BraTS-GLI-01499-000-t2f.nii.gz,../../DataSet/ASNR-MICCAI-BraTS2023-GLI-Challenge-TrainingData/BraTS-GLI-01499-000/BraTS-GLI-01499-000-t1n.nii.gz,../../DataSet/ASNR-MICCAI-BraTS2023-GLI-Challenge-TrainingData/BraTS-GLI-01499-000/BraTS-GLI-01499-000-seg.nii.gz,81,119,52,55,109,83,162,24,82,54,79,58
00828-000,../../DataSet/ASNR-MICCAI-BraTS2023-GLI-Challenge-TrainingData/BraTS-GLI-00828-000/BraTS-GLI-00828-000-t1c.nii.gz,../../DataSet/ASNR-MICCAI-BraTS2023-GLI-Challenge-TrainingData/BraTS-GLI-00828-000/BraTS-GLI-00828-000-t2w.nii.gz,../../DataSet/ASNR-MICCAI-BraTS2023-GLI-Challenge-TrainingData/BraTS-GLI-00828-000/BraTS-GLI-00828-000-t2f.nii.gz,../../DataSet/ASNR-MICCAI-BraTS2023-GLI-Challenge-TrainingData/BraTS-GLI-00828-000/BraTS-GLI-00828-000-t1n.nii.gz,../../DataSet/ASNR-MICCAI-BraTS2023-GLI-Challenge-TrainingData/BraTS-GLI-00828-000/BraTS-GLI-00828-000-seg.nii.gz,111,155,91,83,147,116,194,57,118,64,78,61
00274-000,../../DataSet/ASNR-MICCAI-BraTS2023-GLI-Challenge-TrainingData/BraTS-GLI-00274-000/BraTS-GLI-00274-000-t1c.nii.gz,../../DataSet/ASNR-MICCAI-BraTS2023-GLI-Challenge-TrainingData/BraTS-GLI-00274-000/BraTS-GLI-00274-000-t2w.nii.gz,../../DataSet/ASNR-MICCAI-BraTS2023-GLI-Challenge-TrainingData/BraTS-GLI-00274-000/BraTS-GLI-00274-000-t2f.nii.gz,../../DataSet/ASNR-MICCAI-BraTS2023-GLI-Challenge-TrainingData/BraTS-GLI-00274-000/BraTS-GLI-00274-000-t1n.nii.gz,../../DataSet/ASNR-MICCAI-BraTS2023-GLI-Challenge-TrainingData/BraTS-GLI-00274-000/BraTS-GLI-00274-000-seg.nii.gz,97,169,97,67,117,143,198,71,128,50,55,57
01393-000,../../DataSet/ASNR-MICCAI-BraTS2023-GLI-Challenge-TrainingData/BraTS-GLI-01393-000/BraTS-GLI-01393-000-t1c.nii.gz,../../DataSet/ASNR-MICCAI-BraTS2023-GLI-Challenge-TrainingData/BraTS-GLI-01393-000/BraTS-GLI-01393-000-t2w.nii.gz,../../DataSet/ASNR-MICCAI-BraTS2023-GLI-Challenge-TrainingData/BraTS-GLI-01393-000/BraTS-GLI-01393-000-t2f.nii.gz,../../DataSet/ASNR-MICCAI-BraTS2023-GLI-Challenge-TrainingData/BraTS-GLI-01393-000/BraTS-GLI-01393-000-t1n.nii.gz,../../DataSet/ASNR-MICCAI-BraTS2023-GLI-Challenge-TrainingData/BraTS-GLI-01393-000/BraTS-GLI-01393-000-seg.nii.gz,92,110,103,65,117,80,142,81,130,52,62,49
01434-000,../../DataSet/ASNR-MICCAI-BraTS2023-GLI-Challenge-TrainingData/BraTS-GLI-01434-000/BraTS-GLI-01434-000-t1c.nii.gz,../../DataSet/ASNR-MICCAI-BraTS2023-GLI-Challenge-TrainingData/BraTS-GLI-01434-000/BraTS-GLI-01434-000-t2w.nii.gz,../../DataSet/ASNR-MICCAI-BraTS2023-GLI-Challenge-TrainingData/BraTS-GLI-01434-000/BraTS-GLI-01434-000-t2f.nii.gz,../../DataSet/ASNR-MICCAI-BraTS2023-GLI-Challenge-TrainingData/BraTS-GLI-01434-000/BraTS-GLI-01434-000-t1n.nii.gz,../../DataSet/ASNR-MICCAI-BraTS2023-GLI-Challenge-TrainingData/BraTS-GLI-01434-000/BraTS-GLI-01434-000-seg.nii.gz,134,98,117,120,153,64,124,97,137,33,60,40
01055-000,../../DataSet/ASNR-MICCAI-BraTS2023-GLI-Challenge-TrainingData/BraTS-GLI-01055-000/BraTS-GLI-01055-000-t1c.nii.gz,../../DataSet/ASNR-MICCAI-BraTS2023-GLI-Challenge-TrainingData/BraTS-GLI-01055-000/BraTS-GLI-01055-000-t2w.nii.gz,../../DataSet/ASNR-MICCAI-BraTS2023-GLI-Challenge-TrainingData/BraTS-GLI-01055-000/BraTS-GLI-01055-000-t2f.nii.gz,../../DataSet/ASNR-MICCAI-BraTS2023-GLI-Challenge-TrainingData/BraTS-GLI-01055-000/BraTS-GLI-01055-000-t1n.nii.gz,../../DataSet/ASNR-MICCAI-BraTS2023-GLI-Challenge-TrainingData/BraTS-GLI-01055-000/BraTS-GLI-01055-000-seg.nii.gz,138,160,102,119,170,117,198,70,135,51,81,65
00615-000,../../DataSet/ASNR-MICCAI-BraTS2023-GLI-Challenge-TrainingData/BraTS-GLI-00615-000/BraTS-GLI-00615-000-t1c.nii.gz,../../DataSet/ASNR-MICCAI-BraTS2023-GLI-Challenge-TrainingData/BraTS-GLI-00615-000/BraTS-GLI-00615-000-t2w.nii.gz,../../DataSet/ASNR-MICCAI-BraTS2023-GLI-Challenge-TrainingData/BraTS-GLI-00615-000/BraTS-GLI-00615-000-t2f.nii.gz,../../DataSet/ASNR-MICCAI-BraTS2023-GLI-Challenge-TrainingData/BraTS-GLI-00615-000/BraTS-GLI-00615-000-t1n.nii.gz,../../DataSet/ASNR-MICCAI-BraTS2023-GLI-Challenge-TrainingData/BraTS-GLI-00615-000/BraTS-GLI-00615-000-seg.nii.gz,85,166,55,65,111,137,198,40,76,46,61,36
01084-000,../../DataSet/ASNR-MICCAI-BraTS2023-GLI-Challenge-TrainingData/BraTS-GLI-01084-000/BraTS-GLI-01084-000-t1c.nii.gz,../../DataSet/ASNR-MICCAI-BraTS2023-GLI-Challenge-TrainingData/BraTS-GLI-01084-000/BraTS-GLI-01084-000-t2w.nii.gz,../../DataSet/ASNR-MICCAI-BraTS2023-GLI-Challenge-TrainingData/BraTS-GLI-01084-000/BraTS-GLI-01084-000-t2f.nii.gz,../../DataSet/ASNR-MICCAI-BraTS2023-GLI-Challenge-TrainingData/BraTS-GLI-01084-000/BraTS-GLI-01084-000-t1n.nii.gz,../../DataSet/ASNR-MICCAI-BraTS2023-GLI-Challenge-TrainingData/BraTS-GLI-01084-000/BraTS-GLI-01084-000-seg.nii.gz,132,158,74,97,156,127,194,50,103,59,67,53
01342-000,../../DataSet/ASNR-MICCAI-BraTS2023-GLI-Challenge-TrainingData/BraTS-GLI-01342-000/BraTS-GLI-01342-000-t1c.nii.gz,../../DataSet/ASNR-MICCAI-BraTS2023-GLI-Challenge-TrainingData/BraTS-GLI-01342-000/BraTS-GLI-01342-000-t2w.nii.gz,../../DataSet/ASNR-MICCAI-BraTS2023-GLI-Challenge-TrainingData/BraTS-GLI-01342-000/BraTS-GLI-01342-000-t2f.nii.gz,../../DataSet/ASNR-MICCAI-BraTS2023-GLI-Challenge-TrainingData/BraTS-GLI-01342-000/BraTS-GLI-01342-000-t1n.nii.gz,../../DataSet/ASNR-MICCAI-BraTS2023-GLI-Challenge-TrainingData/BraTS-GLI-01342-000/BraTS-GLI-01342-000-seg.nii.gz,137,83,92,109,168,52,119,62,130,59,67,68
00502-000,../../DataSet/ASNR-MICCAI-BraTS2023-GLI-Challenge-TrainingData/BraTS-GLI-00502-000/BraTS-GLI-00502-000-t1c.nii.gz,../../DataSet/ASNR-MICCAI-BraTS2023-GLI-Challenge-TrainingData/BraTS-GLI-00502-000/BraTS-GLI-00502-000-t2w.nii.gz,../../DataSet/ASNR-MICCAI-BraTS2023-GLI-Challenge-TrainingData/BraTS-GLI-00502-000/BraTS-GLI-00502-000-t2f.nii.gz,../../DataSet/ASNR-MICCAI-BraTS2023-GLI-Challenge-TrainingData/BraTS-GLI-00502-000/BraTS-GLI-00502-000-t1n.nii.gz,../../DataSet/ASNR-MICCAI-BraTS2023-GLI-Challenge-TrainingData/BraTS-GLI-00502-000/BraTS-GLI-00502-000-seg.nii.gz,165,128,68,139,190,81,174,46,101,51,93,55
00403-000,../../DataSet/ASNR-MICCAI-BraTS2023-GLI-Challenge-TrainingData/BraTS-GLI-00403-000/BraTS-GLI-00403-000-t1c.nii.gz,../../DataSet/ASNR-MICCAI-BraTS2023-GLI-Challenge-TrainingData/BraTS-GLI-00403-000/BraTS-GLI-00403-000-t2w.nii.gz,../../DataSet/ASNR-MICCAI-BraTS2023-GLI-Challenge-TrainingData/BraTS-GLI-00403-000/BraTS-GLI-00403-000-t2f.nii.gz,../../DataSet/ASNR-MICCAI-BraTS2023-GLI-Challenge-TrainingData/BraTS-GLI-00403-000/BraTS-GLI-00403-000-t1n.nii.gz,../../DataSet/ASNR-MICCAI-BraTS2023-GLI-Challenge-TrainingData/BraTS-GLI-00403-000/BraTS-GLI-00403-000-seg.nii.gz,163,151,64,143,185,128,177,47,84,42,49,37
00062-000,../../DataSet/ASNR-MICCAI-BraTS2023-GLI-Challenge-TrainingData/BraTS-GLI-00062-000/BraTS-GLI-00062-000-t1c.nii.gz,../../DataSet/ASNR-MICCAI-BraTS2023-GLI-Challenge-TrainingData/BraTS-GLI-00062-000/BraTS-GLI-00062-000-t2w.nii.gz,../../DataSet/ASNR-MICCAI-BraTS2023-GLI-Challenge-TrainingData/BraTS-GLI-00062-000/BraTS-GLI-00062-000-t2f.nii.gz,../../DataSet/ASNR-MICCAI-BraTS2023-GLI-Challenge-TrainingData/BraTS-GLI-00062-000/BraTS-GLI-00062-000-t1n.nii.gz,../../DataSet/ASNR-MICCAI-BraTS2023-GLI-Challenge-TrainingData/BraTS-GLI-00062-000/BraTS-GLI-00062-000-seg.nii.gz,100,81,95,70,134,47,120,61,138,64,73,77
01185-000,../../DataSet/ASNR-MICCAI-BraTS2023-GLI-Challenge-TrainingData/BraTS-GLI-01185-000/BraTS-GLI-01185-000-t1c.nii.gz,../../DataSet/ASNR-MICCAI-BraTS2023-GLI-Challenge-TrainingData/BraTS-GLI-01185-000/BraTS-GLI-01185-000-t2w.nii.gz,../../DataSet/ASNR-MICCAI-BraTS2023-GLI-Challenge-TrainingData/BraTS-GLI-01185-000/BraTS-GLI-01185-000-t2f.nii.gz,../../DataSet/ASNR-MICCAI-BraTS2023-GLI-Challenge-TrainingData/BraTS-GLI-01185-000/BraTS-GLI-01185-000-t1n.nii.gz,../../DataSet/ASNR-MICCAI-BraTS2023-GLI-Challenge-TrainingData/BraTS-GLI-01185-000/BraTS-GLI-01185-000-seg.nii.gz,88,143,71,59,119,98,193,30,113,60,95,83
01154-000,../../DataSet/ASNR-MICCAI-BraTS2023-GLI-Challenge-TrainingData/BraTS-GLI-01154-000/BraTS-GLI-01154-000-t1c.nii.gz,../../DataSet/ASNR-MICCAI-BraTS2023-GLI-Challenge-TrainingData/BraTS-GLI-01154-000/BraTS-GLI-01154-000-t2w.nii.gz,../../DataSet/ASNR-MICCAI-BraTS2023-GLI-Challenge-TrainingData/BraTS-GLI-01154-000/BraTS-GLI-01154-000-t2f.nii.gz,../../DataSet/ASNR-MICCAI-BraTS2023-GLI-Challenge-TrainingData/BraTS-GLI-01154-000/BraTS-GLI-01154-000-t1n.nii.gz,../../DataSet/ASNR-MICCAI-BraTS2023-GLI-Challenge-TrainingData/BraTS-GLI-01154-000/BraTS-GLI-01154-000-seg.nii.gz,140,113,61,115,166,92,149,47,76,51,57,29
00375-000,../../DataSet/ASNR-MICCAI-BraTS2023-GLI-Challenge-TrainingData/BraTS-GLI-00375-000/BraTS-GLI-00375-000-t1c.nii.gz,../../DataSet/ASNR-MICCAI-BraTS2023-GLI-Challenge-TrainingData/BraTS-GLI-00375-000/BraTS-GLI-00375-000-t2w.nii.gz,../../DataSet/ASNR-MICCAI-BraTS2023-GLI-Challenge-TrainingData/BraTS-GLI-00375-000/BraTS-GLI-00375-000-t2f.nii.gz,../../DataSet/ASNR-MICCAI-BraTS2023-GLI-Challenge-TrainingData/BraTS-GLI-00375-000/BraTS-GLI-00375-000-t1n.nii.gz,../../DataSet/ASNR-MICCAI-BraTS2023-GLI-Challenge-TrainingData/BraTS-GLI-00375-000/BraTS-GLI-00375-000-seg.nii.gz,82,149,84,53,116,105,191,47,127,63,86,80
00550-001,../../DataSet/ASNR-MICCAI-BraTS2023-GLI-Challenge-TrainingData/BraTS-GLI-00550-001/BraTS-GLI-00550-001-t1c.nii.gz,../../DataSet/ASNR-MICCAI-BraTS2023-GLI-Challenge-TrainingData/BraTS-GLI-00550-001/BraTS-GLI-00550-001-t2w.nii.gz,../../DataSet/ASNR-MICCAI-BraTS2023-GLI-Challenge-TrainingData/BraTS-GLI-00550-001/BraTS-GLI-00550-001-t2f.nii.gz,../../DataSet/ASNR-MICCAI-BraTS2023-GLI-Challenge-TrainingData/BraTS-GLI-00550-001/BraTS-GLI-00550-001-t1n.nii.gz,../../DataSet/ASNR-MICCAI-BraTS2023-GLI-Challenge-TrainingData/BraTS-GLI-00550-001/BraTS-GLI-00550-001-seg.nii.gz,154,112,57,129,175,89,138,35,80,46,49,45
01292-000,../../DataSet/ASNR-MICCAI-BraTS2023-GLI-Challenge-TrainingData/BraTS-GLI-01292-000/BraTS-GLI-01292-000-t1c.nii.gz,../../DataSet/ASNR-MICCAI-BraTS2023-GLI-Challenge-TrainingData/BraTS-GLI-01292-000/BraTS-GLI-01292-000-t2w.nii.gz,../../DataSet/ASNR-MICCAI-BraTS2023-GLI-Challenge-TrainingData/BraTS-GLI-01292-000/BraTS-GLI-01292-000-t2f.nii.gz,../../DataSet/ASNR-MICCAI-BraTS2023-GLI-Challenge-TrainingData/BraTS-GLI-01292-000/BraTS-GLI-01292-000-t1n.nii.gz,../../DataSet/ASNR-MICCAI-BraTS2023-GLI-Challenge-TrainingData/BraTS-GLI-01292-000/BraTS-GLI-01292-000-seg.nii.gz,89,169,82,62,130,139,202,26,115,68,63,89
01535-000,../../DataSet/ASNR-MICCAI-BraTS2023-GLI-Challenge-TrainingData/BraTS-GLI-01535-000/BraTS-GLI-01535-000-t1c.nii.gz,../../DataSet/ASNR-MICCAI-BraTS2023-GLI-Challenge-TrainingData/BraTS-GLI-01535-000/BraTS-GLI-01535-000-t2w.nii.gz,../../DataSet/ASNR-MICCAI-BraTS2023-GLI-Challenge-TrainingData/BraTS-GLI-01535-000/BraTS-GLI-01535-000-t2f.nii.gz,../../DataSet/ASNR-MICCAI-BraTS2023-GLI-Challenge-TrainingData/BraTS-GLI-01535-000/BraTS-GLI-01535-000-t1n.nii.gz,../../DataSet/ASNR-MICCAI-BraTS2023-GLI-Challenge-TrainingData/BraTS-GLI-01535-000/BraTS-GLI-01535-000-seg.nii.gz,151,113,63,122,175,89,149,36,90,53,60,54
00630-000,../../DataSet/ASNR-MICCAI-BraTS2023-GLI-Challenge-TrainingData/BraTS-GLI-00630-000/BraTS-GLI-00630-000-t1c.nii.gz,../../DataSet/ASNR-MICCAI-BraTS2023-GLI-Challenge-TrainingData/BraTS-GLI-00630-000/BraTS-GLI-00630-000-t2w.nii.gz,../../DataSet/ASNR-MICCAI-BraTS2023-GLI-Challenge-TrainingData/BraTS-GLI-00630-000/BraTS-GLI-00630-000-t2f.nii.gz,../../DataSet/ASNR-MICCAI-BraTS2023-GLI-Challenge-TrainingData/BraTS-GLI-00630-000/BraTS-GLI-00630-000-t1n.nii.gz,../../DataSet/ASNR-MICCAI-BraTS2023-GLI-Challenge-TrainingData/BraTS-GLI-00630-000/BraTS-GLI-00630-000-seg.nii.gz,142,126,80,113,172,102,152,54,115,59,50,61
00251-000,../../DataSet/ASNR-MICCAI-BraTS2023-GLI-Challenge-TrainingData/BraTS-GLI-00251-000/BraTS-GLI-00251-000-t1c.nii.gz,../../DataSet/ASNR-MICCAI-BraTS2023-GLI-Challenge-TrainingData/BraTS-GLI-00251-000/BraTS-GLI-00251-000-t2w.nii.gz,../../DataSet/ASNR-MICCAI-BraTS2023-GLI-Challenge-TrainingData/BraTS-GLI-00251-000/BraTS-GLI-00251-000-t2f.nii.gz,../../DataSet/ASNR-MICCAI-BraTS2023-GLI-Challenge-TrainingData/BraTS-GLI-00251-000/BraTS-GLI-00251-000-t1n.nii.gz,../../DataSet/ASNR-MICCAI-BraTS2023-GLI-Challenge-TrainingData/BraTS-GLI-00251-000/BraTS-GLI-00251-000-seg.nii.gz,96,91,89,82,111,80,110,76,102,29,30,26
01411-000,../../DataSet/ASNR-MICCAI-BraTS2023-GLI-Challenge-TrainingData/BraTS-GLI-01411-000/BraTS-GLI-01411-000-t1c.nii.gz,../../DataSet/ASNR-MICCAI-BraTS2023-GLI-Challenge-TrainingData/BraTS-GLI-01411-000/BraTS-GLI-01411-000-t2w.nii.gz,../../DataSet/ASNR-MICCAI-BraTS2023-GLI-Challenge-TrainingData/BraTS-GLI-01411-000/BraTS-GLI-01411-000-t2f.nii.gz,../../DataSet/ASNR-MICCAI-BraTS2023-GLI-Challenge-TrainingData/BraTS-GLI-01411-000/BraTS-GLI-01411-000-t1n.nii.gz,../../DataSet/ASNR-MICCAI-BraTS2023-GLI-Challenge-TrainingData/BraTS-GLI-01411-000/BraTS-GLI-01411-000-seg.nii.gz,82,123,67,58,112,77,172,30,103,54,95,73
01367-000,../../DataSet/ASNR-MICCAI-BraTS2023-GLI-Challenge-TrainingData/BraTS-GLI-01367-000/BraTS-GLI-01367-000-t1c.nii.gz,../../DataSet/ASNR-MICCAI-BraTS2023-GLI-Challenge-TrainingData/BraTS-GLI-01367-000/BraTS-GLI-01367-000-t2w.nii.gz,../../DataSet/ASNR-MICCAI-BraTS2023-GLI-Challenge-TrainingData/BraTS-GLI-01367-000/BraTS-GLI-01367-000-t2f.nii.gz,../../DataSet/ASNR-MICCAI-BraTS2023-GLI-Challenge-TrainingData/BraTS-GLI-01367-000/BraTS-GLI-01367-000-t1n.nii.gz,../../DataSet/ASNR-MICCAI-BraTS2023-GLI-Challenge-TrainingData/BraTS-GLI-01367-000/BraTS-GLI-01367-000-seg.nii.gz,99,169,84,85,120,114,205,51,120,35,91,69
00280-000,../../DataSet/ASNR-MICCAI-BraTS2023-GLI-Challenge-TrainingData/BraTS-GLI-00280-000/BraTS-GLI-00280-000-t1c.nii.gz,../../DataSet/ASNR-MICCAI-BraTS2023-GLI-Challenge-TrainingData/BraTS-GLI-00280-000/BraTS-GLI-00280-000-t2w.nii.gz,../../DataSet/ASNR-MICCAI-BraTS2023-GLI-Challenge-TrainingData/BraTS-GLI-00280-000/BraTS-GLI-00280-000-t2f.nii.gz,../../DataSet/ASNR-MICCAI-BraTS2023-GLI-Challenge-TrainingData/BraTS-GLI-00280-000/BraTS-GLI-00280-000-t1n.nii.gz,../../DataSet/ASNR-MICCAI-BraTS2023-GLI-Challenge-TrainingData/BraTS-GLI-00280-000/BraTS-GLI-00280-000-seg.nii.gz,80,109,70,62,101,83,143,47,113,39,60,66
01128-000,../../DataSet/ASNR-MICCAI-BraTS2023-GLI-Challenge-TrainingData/BraTS-GLI-01128-000/BraTS-GLI-01128-000-t1c.nii.gz,../../DataSet/ASNR-MICCAI-BraTS2023-GLI-Challenge-TrainingData/BraTS-GLI-01128-000/BraTS-GLI-01128-000-t2w.nii.gz,../../DataSet/ASNR-MICCAI-BraTS2023-GLI-Challenge-TrainingData/BraTS-GLI-01128-000/BraTS-GLI-01128-000-t2f.nii.gz,../../DataSet/ASNR-MICCAI-BraTS2023-GLI-Challenge-TrainingData/BraTS-GLI-01128-000/BraTS-GLI-01128-000-t1n.nii.gz,../../DataSet/ASNR-MICCAI-BraTS2023-GLI-Challenge-TrainingData/BraTS-GLI-01128-000/BraTS-GLI-01128-000-seg.nii.gz,108,127,71,90,124,105,150,29,93,34,45,64
00768-000,../../DataSet/ASNR-MICCAI-BraTS2023-GLI-Challenge-TrainingData/BraTS-GLI-00768-000/BraTS-GLI-00768-000-t1c.nii.gz,../../DataSet/ASNR-MICCAI-BraTS2023-GLI-Challenge-TrainingData/BraTS-GLI-00768-000/BraTS-GLI-00768-000-t2w.nii.gz,../../DataSet/ASNR-MICCAI-BraTS2023-GLI-Challenge-TrainingData/BraTS-GLI-00768-000/BraTS-GLI-00768-000-t2f.nii.gz,../../DataSet/ASNR-MICCAI-BraTS2023-GLI-Challenge-TrainingData/BraTS-GLI-00768-000/BraTS-GLI-00768-000-t1n.nii.gz,../../DataSet/ASNR-MICCAI-BraTS2023-GLI-Challenge-TrainingData/BraTS-GLI-00768-000/BraTS-GLI-00768-000-seg.nii.gz,131,83,92,102,157,46,133,63,122,55,87,59
00309-000,../../DataSet/ASNR-MICCAI-BraTS2023-GLI-Challenge-TrainingData/BraTS-GLI-00309-000/BraTS-GLI-00309-000-t1c.nii.gz,../../DataSet/ASNR-MICCAI-BraTS2023-GLI-Challenge-TrainingData/BraTS-GLI-00309-000/BraTS-GLI-00309-000-t2w.nii.gz,../../DataSet/ASNR-MICCAI-BraTS2023-GLI-Challenge-TrainingData/BraTS-GLI-00309-000/BraTS-GLI-00309-000-t2f.nii.gz,../../DataSet/ASNR-MICCAI-BraTS2023-GLI-Challenge-TrainingData/BraTS-GLI-00309-000/BraTS-GLI-00309-000-t1n.nii.gz,../../DataSet/ASNR-MICCAI-BraTS2023-GLI-Challenge-TrainingData/BraTS-GLI-00309-000/BraTS-GLI-00309-000-seg.nii.gz,76,154,85,56,102,131,185,58,108,46,54,50
01077-000,../../DataSet/ASNR-MICCAI-BraTS2023-GLI-Challenge-TrainingData/BraTS-GLI-01077-000/BraTS-GLI-01077-000-t1c.nii.gz,../../DataSet/ASNR-MICCAI-BraTS2023-GLI-Challenge-TrainingData/BraTS-GLI-01077-000/BraTS-GLI-01077-000-t2w.nii.gz,../../DataSet/ASNR-MICCAI-BraTS2023-GLI-Challenge-TrainingData/BraTS-GLI-01077-000/BraTS-GLI-01077-000-t2f.nii.gz,../../DataSet/ASNR-MICCAI-BraTS2023-GLI-Challenge-TrainingData/BraTS-GLI-01077-000/BraTS-GLI-01077-000-t1n.nii.gz,../../DataSet/ASNR-MICCAI-BraTS2023-GLI-Challenge-TrainingData/BraTS-GLI-01077-000/BraTS-GLI-01077-000-seg.nii.gz,73,173,98,63,84,164,186,83,116,21,22,33
00520-000,../../DataSet/ASNR-MICCAI-BraTS2023-GLI-Challenge-TrainingData/BraTS-GLI-00520-000/BraTS-GLI-00520-000-t1c.nii.gz,../../DataSet/ASNR-MICCAI-BraTS2023-GLI-Challenge-TrainingData/BraTS-GLI-00520-000/BraTS-GLI-00520-000-t2w.nii.gz,../../DataSet/ASNR-MICCAI-BraTS2023-GLI-Challenge-TrainingData/BraTS-GLI-00520-000/BraTS-GLI-00520-000-t2f.nii.gz,../../DataSet/ASNR-MICCAI-BraTS2023-GLI-Challenge-TrainingData/BraTS-GLI-00520-000/BraTS-GLI-00520-000-t1n.nii.gz,../../DataSet/ASNR-MICCAI-BraTS2023-GLI-Challenge-TrainingData/BraTS-GLI-00520-000/BraTS-GLI-00520-000-seg.nii.gz,155,149,91,133,177,121,177,70,115,44,56,45
00478-000,../../DataSet/ASNR-MICCAI-BraTS2023-GLI-Challenge-TrainingData/BraTS-GLI-00478-000/BraTS-GLI-00478-000-t1c.nii.gz,../../DataSet/ASNR-MICCAI-BraTS2023-GLI-Challenge-TrainingData/BraTS-GLI-00478-000/BraTS-GLI-00478-000-t2w.nii.gz,../../DataSet/ASNR-MICCAI-BraTS2023-GLI-Challenge-TrainingData/BraTS-GLI-00478-000/BraTS-GLI-00478-000-t2f.nii.gz,../../DataSet/ASNR-MICCAI-BraTS2023-GLI-Challenge-TrainingData/BraTS-GLI-00478-000/BraTS-GLI-00478-000-t1n.nii.gz,../../DataSet/ASNR-MICCAI-BraTS2023-GLI-Challenge-TrainingData/BraTS-GLI-00478-000/BraTS-GLI-00478-000-seg.nii.gz,87,137,93,61,114,103,171,66,126,53,68,60
01238-000,../../DataSet/ASNR-MICCAI-BraTS2023-GLI-Challenge-TrainingData/BraTS-GLI-01238-000/BraTS-GLI-01238-000-t1c.nii.gz,../../DataSet/ASNR-MICCAI-BraTS2023-GLI-Challenge-TrainingData/BraTS-GLI-01238-000/BraTS-GLI-01238-000-t2w.nii.gz,../../DataSet/ASNR-MICCAI-BraTS2023-GLI-Challenge-TrainingData/BraTS-GLI-01238-000/BraTS-GLI-01238-000-t2f.nii.gz,../../DataSet/ASNR-MICCAI-BraTS2023-GLI-Challenge-TrainingData/BraTS-GLI-01238-000/BraTS-GLI-01238-000-t1n.nii.gz,../../DataSet/ASNR-MICCAI-BraTS2023-GLI-Challenge-TrainingData/BraTS-GLI-01238-000/BraTS-GLI-01238-000-seg.nii.gz,85,155,84,58,111,109,201,46,133,53,92,87
01244-000,../../DataSet/ASNR-MICCAI-BraTS2023-GLI-Challenge-TrainingData/BraTS-GLI-01244-000/BraTS-GLI-01244-000-t1c.nii.gz,../../DataSet/ASNR-MICCAI-BraTS2023-GLI-Challenge-TrainingData/BraTS-GLI-01244-000/BraTS-GLI-01244-000-t2w.nii.gz,../../DataSet/ASNR-MICCAI-BraTS2023-GLI-Challenge-TrainingData/BraTS-GLI-01244-000/BraTS-GLI-01244-000-t2f.nii.gz,../../DataSet/ASNR-MICCAI-BraTS2023-GLI-Challenge-TrainingData/BraTS-GLI-01244-000/BraTS-GLI-01244-000-t1n.nii.gz,../../DataSet/ASNR-MICCAI-BraTS2023-GLI-Challenge-TrainingData/BraTS-GLI-01244-000/BraTS-GLI-01244-000-seg.nii.gz,137,148,106,118,168,113,190,67,136,50,77,69
00691-001,../../DataSet/ASNR-MICCAI-BraTS2023-GLI-Challenge-TrainingData/BraTS-GLI-00691-001/BraTS-GLI-00691-001-t1c.nii.gz,../../DataSet/ASNR-MICCAI-BraTS2023-GLI-Challenge-TrainingData/BraTS-GLI-00691-001/BraTS-GLI-00691-001-t2w.nii.gz,../../DataSet/ASNR-MICCAI-BraTS2023-GLI-Challenge-TrainingData/BraTS-GLI-00691-001/BraTS-GLI-00691-001-t2f.nii.gz,../../DataSet/ASNR-MICCAI-BraTS2023-GLI-Challenge-TrainingData/BraTS-GLI-00691-001/BraTS-GLI-00691-001-t1n.nii.gz,../../DataSet/ASNR-MICCAI-BraTS2023-GLI-Challenge-TrainingData/BraTS-GLI-00691-001/BraTS-GLI-00691-001-seg.nii.gz,148,129,77,130,169,87,162,51,114,39,75,63
01295-000,../../DataSet/ASNR-MICCAI-BraTS2023-GLI-Challenge-TrainingData/BraTS-GLI-01295-000/BraTS-GLI-01295-000-t1c.nii.gz,../../DataSet/ASNR-MICCAI-BraTS2023-GLI-Challenge-TrainingData/BraTS-GLI-01295-000/BraTS-GLI-01295-000-t2w.nii.gz,../../DataSet/ASNR-MICCAI-BraTS2023-GLI-Challenge-TrainingData/BraTS-GLI-01295-000/BraTS-GLI-01295-000-t2f.nii.gz,../../DataSet/ASNR-MICCAI-BraTS2023-GLI-Challenge-TrainingData/BraTS-GLI-01295-000/BraTS-GLI-01295-000-t1n.nii.gz,../../DataSet/ASNR-MICCAI-BraTS2023-GLI-Challenge-TrainingData/BraTS-GLI-01295-000/BraTS-GLI-01295-000-seg.nii.gz,160,143,84,129,181,90,167,63,122,52,77,59
00639-000,../../DataSet/ASNR-MICCAI-BraTS2023-GLI-Challenge-TrainingData/BraTS-GLI-00639-000/BraTS-GLI-00639-000-t1c.nii.gz,../../DataSet/ASNR-MICCAI-BraTS2023-GLI-Challenge-TrainingData/BraTS-GLI-00639-000/BraTS-GLI-00639-000-t2w.nii.gz,../../DataSet/ASNR-MICCAI-BraTS2023-GLI-Challenge-TrainingData/BraTS-GLI-00639-000/BraTS-GLI-00639-000-t2f.nii.gz,../../DataSet/ASNR-MICCAI-BraTS2023-GLI-Challenge-TrainingData/BraTS-GLI-00639-000/BraTS-GLI-00639-000-t1n.nii.gz,../../DataSet/ASNR-MICCAI-BraTS2023-GLI-Challenge-TrainingData/BraTS-GLI-00639-000/BraTS-GLI-00639-000-seg.nii.gz,91,97,88,68,113,72,124,68,111,45,52,43
00258-000,../../DataSet/ASNR-MICCAI-BraTS2023-GLI-Challenge-TrainingData/BraTS-GLI-00258-000/BraTS-GLI-00258-000-t1c.nii.gz,../../DataSet/ASNR-MICCAI-BraTS2023-GLI-Challenge-TrainingData/BraTS-GLI-00258-000/BraTS-GLI-00258-000-t2w.nii.gz,../../DataSet/ASNR-MICCAI-BraTS2023-GLI-Challenge-TrainingData/BraTS-GLI-00258-000/BraTS-GLI-00258-000-t2f.nii.gz,../../DataSet/ASNR-MICCAI-BraTS2023-GLI-Challenge-TrainingData/BraTS-GLI-00258-000/BraTS-GLI-00258-000-t1n.nii.gz,../../DataSet/ASNR-MICCAI-BraTS2023-GLI-Challenge-TrainingData/BraTS-GLI-00258-000/BraTS-GLI-00258-000-seg.nii.gz,141,120,64,118,158,75,164,48,89,40,89,41
00289-000,../../DataSet/ASNR-MICCAI-BraTS2023-GLI-Challenge-TrainingData/BraTS-GLI-00289-000/BraTS-GLI-00289-000-t1c.nii.gz,../../DataSet/ASNR-MICCAI-BraTS2023-GLI-Challenge-TrainingData/BraTS-GLI-00289-000/BraTS-GLI-00289-000-t2w.nii.gz,../../DataSet/ASNR-MICCAI-BraTS2023-GLI-Challenge-TrainingData/BraTS-GLI-00289-000/BraTS-GLI-00289-000-t2f.nii.gz,../../DataSet/ASNR-MICCAI-BraTS2023-GLI-Challenge-TrainingData/BraTS-GLI-00289-000/BraTS-GLI-00289-000-t1n.nii.gz,../../DataSet/ASNR-MICCAI-BraTS2023-GLI-Challenge-TrainingData/BraTS-GLI-00289-000/BraTS-GLI-00289-000-seg.nii.gz,151,159,56,132,173,112,196,40,87,41,84,47
01236-000,../../DataSet/ASNR-MICCAI-BraTS2023-GLI-Challenge-TrainingData/BraTS-GLI-01236-000/BraTS-GLI-01236-000-t1c.nii.gz,../../DataSet/ASNR-MICCAI-BraTS2023-GLI-Challenge-TrainingData/BraTS-GLI-01236-000/BraTS-GLI-01236-000-t2w.nii.gz,../../DataSet/ASNR-MICCAI-BraTS2023-GLI-Challenge-TrainingData/BraTS-GLI-01236-000/BraTS-GLI-01236-000-t2f.nii.gz,../../DataSet/ASNR-MICCAI-BraTS2023-GLI-Challenge-TrainingData/BraTS-GLI-01236-000/BraTS-GLI-01236-000-t1n.nii.gz,../../DataSet/ASNR-MICCAI-BraTS2023-GLI-Challenge-TrainingData/BraTS-GLI-01236-000/BraTS-GLI-01236-000-seg.nii.gz,137,99,106,116,165,60,140,75,141,49,80,66
00017-000,../../DataSet/ASNR-MICCAI-BraTS2023-GLI-Challenge-TrainingData/BraTS-GLI-00017-000/BraTS-GLI-00017-000-t1c.nii.gz,../../DataSet/ASNR-MICCAI-BraTS2023-GLI-Challenge-TrainingData/BraTS-GLI-00017-000/BraTS-GLI-00017-000-t2w.nii.gz,../../DataSet/ASNR-MICCAI-BraTS2023-GLI-Challenge-TrainingData/BraTS-GLI-00017-000/BraTS-GLI-00017-000-t2f.nii.gz,../../DataSet/ASNR-MICCAI-BraTS2023-GLI-Challenge-TrainingData/BraTS-GLI-00017-000/BraTS-GLI-00017-000-t1n.nii.gz,../../DataSet/ASNR-MICCAI-BraTS2023-GLI-Challenge-TrainingData/BraTS-GLI-00017-000/BraTS-GLI-00017-000-seg.nii.gz,168,144,74,139,192,105,183,44,115,53,78,71
00525-001,../../DataSet/ASNR-MICCAI-BraTS2023-GLI-Challenge-TrainingData/BraTS-GLI-00525-001/BraTS-GLI-00525-001-t1c.nii.gz,../../DataSet/ASNR-MICCAI-BraTS2023-GLI-Challenge-TrainingData/BraTS-GLI-00525-001/BraTS-GLI-00525-001-t2w.nii.gz,../../DataSet/ASNR-MICCAI-BraTS2023-GLI-Challenge-TrainingData/BraTS-GLI-00525-001/BraTS-GLI-00525-001-t2f.nii.gz,../../DataSet/ASNR-MICCAI-BraTS2023-GLI-Challenge-TrainingData/BraTS-GLI-00525-001/BraTS-GLI-00525-001-t1n.nii.gz,../../DataSet/ASNR-MICCAI-BraTS2023-GLI-Challenge-TrainingData/BraTS-GLI-00525-001/BraTS-GLI-00525-001-seg.nii.gz,152,115,59,127,178,84,154,27,92,51,70,65
01005-000,../../DataSet/ASNR-MICCAI-BraTS2023-GLI-Challenge-TrainingData/BraTS-GLI-01005-000/BraTS-GLI-01005-000-t1c.nii.gz,../../DataSet/ASNR-MICCAI-BraTS2023-GLI-Challenge-TrainingData/BraTS-GLI-01005-000/BraTS-GLI-01005-000-t2w.nii.gz,../../DataSet/ASNR-MICCAI-BraTS2023-GLI-Challenge-TrainingData/BraTS-GLI-01005-000/BraTS-GLI-01005-000-t2f.nii.gz,../../DataSet/ASNR-MICCAI-BraTS2023-GLI-Challenge-TrainingData/BraTS-GLI-01005-000/BraTS-GLI-01005-000-t1n.nii.gz,../../DataSet/ASNR-MICCAI-BraTS2023-GLI-Challenge-TrainingData/BraTS-GLI-01005-000/BraTS-GLI-01005-000-seg.nii.gz,103,156,86,77,149,95,189,50,130,72,94,80
00645-000,../../DataSet/ASNR-MICCAI-BraTS2023-GLI-Challenge-TrainingData/BraTS-GLI-00645-000/BraTS-GLI-00645-000-t1c.nii.gz,../../DataSet/ASNR-MICCAI-BraTS2023-GLI-Challenge-TrainingData/BraTS-GLI-00645-000/BraTS-GLI-00645-000-t2w.nii.gz,../../DataSet/ASNR-MICCAI-BraTS2023-GLI-Challenge-TrainingData/BraTS-GLI-00645-000/BraTS-GLI-00645-000-t2f.nii.gz,../../DataSet/ASNR-MICCAI-BraTS2023-GLI-Challenge-TrainingData/BraTS-GLI-00645-000/BraTS-GLI-00645-000-t1n.nii.gz,../../DataSet/ASNR-MICCAI-BraTS2023-GLI-Challenge-TrainingData/BraTS-GLI-00645-000/BraTS-GLI-00645-000-seg.nii.gz,143,92,108,124,179,67,129,79,129,55,62,50
00583-000,../../DataSet/ASNR-MICCAI-BraTS2023-GLI-Challenge-TrainingData/BraTS-GLI-00583-000/BraTS-GLI-00583-000-t1c.nii.gz,../../DataSet/ASNR-MICCAI-BraTS2023-GLI-Challenge-TrainingData/BraTS-GLI-00583-000/BraTS-GLI-00583-000-t2w.nii.gz,../../DataSet/ASNR-MICCAI-BraTS2023-GLI-Challenge-TrainingData/BraTS-GLI-00583-000/BraTS-GLI-00583-000-t2f.nii.gz,../../DataSet/ASNR-MICCAI-BraTS2023-GLI-Challenge-TrainingData/BraTS-GLI-00583-000/BraTS-GLI-00583-000-t1n.nii.gz,../../DataSet/ASNR-MICCAI-BraTS2023-GLI-Challenge-TrainingData/BraTS-GLI-00583-000/BraTS-GLI-00583-000-seg.nii.gz,153,127,65,120,183,86,176,26,100,63,90,74
01464-000,../../DataSet/ASNR-MICCAI-BraTS2023-GLI-Challenge-TrainingData/BraTS-GLI-01464-000/BraTS-GLI-01464-000-t1c.nii.gz,../../DataSet/ASNR-MICCAI-BraTS2023-GLI-Challenge-TrainingData/BraTS-GLI-01464-000/BraTS-GLI-01464-000-t2w.nii.gz,../../DataSet/ASNR-MICCAI-BraTS2023-GLI-Challenge-TrainingData/BraTS-GLI-01464-000/BraTS-GLI-01464-000-t2f.nii.gz,../../DataSet/ASNR-MICCAI-BraTS2023-GLI-Challenge-TrainingData/BraTS-GLI-01464-000/BraTS-GLI-01464-000-t1n.nii.gz,../../DataSet/ASNR-MICCAI-BraTS2023-GLI-Challenge-TrainingData/BraTS-GLI-01464-000/BraTS-GLI-01464-000-seg.nii.gz,89,140,103,68,107,121,164,75,127,39,43,52
01312-000,../../DataSet/ASNR-MICCAI-BraTS2023-GLI-Challenge-TrainingData/BraTS-GLI-01312-000/BraTS-GLI-01312-000-t1c.nii.gz,../../DataSet/ASNR-MICCAI-BraTS2023-GLI-Challenge-TrainingData/BraTS-GLI-01312-000/BraTS-GLI-01312-000-t2w.nii.gz,../../DataSet/ASNR-MICCAI-BraTS2023-GLI-Challenge-TrainingData/BraTS-GLI-01312-000/BraTS-GLI-01312-000-t2f.nii.gz,../../DataSet/ASNR-MICCAI-BraTS2023-GLI-Challenge-TrainingData/BraTS-GLI-01312-000/BraTS-GLI-01312-000-t1n.nii.gz,../../DataSet/ASNR-MICCAI-BraTS2023-GLI-Challenge-TrainingData/BraTS-GLI-01312-000/BraTS-GLI-01312-000-seg.nii.gz,159,166,80,135,186,139,200,53,112,51,61,59
00694-000,../../DataSet/ASNR-MICCAI-BraTS2023-GLI-Challenge-TrainingData/BraTS-GLI-00694-000/BraTS-GLI-00694-000-t1c.nii.gz,../../DataSet/ASNR-MICCAI-BraTS2023-GLI-Challenge-TrainingData/BraTS-GLI-00694-000/BraTS-GLI-00694-000-t2w.nii.gz,../../DataSet/ASNR-MICCAI-BraTS2023-GLI-Challenge-TrainingData/BraTS-GLI-00694-000/BraTS-GLI-00694-000-t2f.nii.gz,../../DataSet/ASNR-MICCAI-BraTS2023-GLI-Challenge-TrainingData/BraTS-GLI-00694-000/BraTS-GLI-00694-000-t1n.nii.gz,../../DataSet/ASNR-MICCAI-BraTS2023-GLI-Challenge-TrainingData/BraTS-GLI-00694-000/BraTS-GLI-00694-000-seg.nii.gz,96,155,101,66,131,123,193,63,140,65,70,77
00133-000,../../DataSet/ASNR-MICCAI-BraTS2023-GLI-Challenge-TrainingData/BraTS-GLI-00133-000/BraTS-GLI-00133-000-t1c.nii.gz,../../DataSet/ASNR-MICCAI-BraTS2023-GLI-Challenge-TrainingData/BraTS-GLI-00133-000/BraTS-GLI-00133-000-t2w.nii.gz,../../DataSet/ASNR-MICCAI-BraTS2023-GLI-Challenge-TrainingData/BraTS-GLI-00133-000/BraTS-GLI-00133-000-t2f.nii.gz,../../DataSet/ASNR-MICCAI-BraTS2023-GLI-Challenge-TrainingData/BraTS-GLI-00133-000/BraTS-GLI-00133-000-t1n.nii.gz,../../DataSet/ASNR-MICCAI-BraTS2023-GLI-Challenge-TrainingData/BraTS-GLI-00133-000/BraTS-GLI-00133-000-seg.nii.gz,85,122,59,54,125,86,170,27,100,71,84,73
00642-000,../../DataSet/ASNR-MICCAI-BraTS2023-GLI-Challenge-TrainingData/BraTS-GLI-00642-000/BraTS-GLI-00642-000-t1c.nii.gz,../../DataSet/ASNR-MICCAI-BraTS2023-GLI-Challenge-TrainingData/BraTS-GLI-00642-000/BraTS-GLI-00642-000-t2w.nii.gz,../../DataSet/ASNR-MICCAI-BraTS2023-GLI-Challenge-TrainingData/BraTS-GLI-00642-000/BraTS-GLI-00642-000-t2f.nii.gz,../../DataSet/ASNR-MICCAI-BraTS2023-GLI-Challenge-TrainingData/BraTS-GLI-00642-000/BraTS-GLI-00642-000-t1n.nii.gz,../../DataSet/ASNR-MICCAI-BraTS2023-GLI-Challenge-TrainingData/BraTS-GLI-00642-000/BraTS-GLI-00642-000-seg.nii.gz,154,150,87,130,184,119,186,67,110,54,67,43
01002-000,../../DataSet/ASNR-MICCAI-BraTS2023-GLI-Challenge-TrainingData/BraTS-GLI-01002-000/BraTS-GLI-01002-000-t1c.nii.gz,../../DataSet/ASNR-MICCAI-BraTS2023-GLI-Challenge-TrainingData/BraTS-GLI-01002-000/BraTS-GLI-01002-000-t2w.nii.gz,../../DataSet/ASNR-MICCAI-BraTS2023-GLI-Challenge-TrainingData/BraTS-GLI-01002-000/BraTS-GLI-01002-000-t2f.nii.gz,../../DataSet/ASNR-MICCAI-BraTS2023-GLI-Challenge-TrainingData/BraTS-GLI-01002-000/BraTS-GLI-01002-000-t1n.nii.gz,../../DataSet/ASNR-MICCAI-BraTS2023-GLI-Challenge-TrainingData/BraTS-GLI-01002-000/BraTS-GLI-01002-000-seg.nii.gz,159,144,65,137,184,110,176,38,92,47,66,54
01463-000,../../DataSet/ASNR-MICCAI-BraTS2023-GLI-Challenge-TrainingData/BraTS-GLI-01463-000/BraTS-GLI-01463-000-t1c.nii.gz,../../DataSet/ASNR-MICCAI-BraTS2023-GLI-Challenge-TrainingData/BraTS-GLI-01463-000/BraTS-GLI-01463-000-t2w.nii.gz,../../DataSet/ASNR-MICCAI-BraTS2023-GLI-Challenge-TrainingData/BraTS-GLI-01463-000/BraTS-GLI-01463-000-t2f.nii.gz,../../DataSet/ASNR-MICCAI-BraTS2023-GLI-Challenge-TrainingData/BraTS-GLI-01463-000/BraTS-GLI-01463-000-t1n.nii.gz,../../DataSet/ASNR-MICCAI-BraTS2023-GLI-Challenge-TrainingData/BraTS-GLI-01463-000/BraTS-GLI-01463-000-seg.nii.gz,149,165,74,105,182,119,210,37,110,77,91,73
00584-000,../../DataSet/ASNR-MICCAI-BraTS2023-GLI-Challenge-TrainingData/BraTS-GLI-00584-000/BraTS-GLI-00584-000-t1c.nii.gz,../../DataSet/ASNR-MICCAI-BraTS2023-GLI-Challenge-TrainingData/BraTS-GLI-00584-000/BraTS-GLI-00584-000-t2w.nii.gz,../../DataSet/ASNR-MICCAI-BraTS2023-GLI-Challenge-TrainingData/BraTS-GLI-00584-000/BraTS-GLI-00584-000-t2f.nii.gz,../../DataSet/ASNR-MICCAI-BraTS2023-GLI-Challenge-TrainingData/BraTS-GLI-00584-000/BraTS-GLI-00584-000-t1n.nii.gz,../../DataSet/ASNR-MICCAI-BraTS2023-GLI-Challenge-TrainingData/BraTS-GLI-00584-000/BraTS-GLI-00584-000-seg.nii.gz,169,128,58,156,183,109,156,46,74,27,47,28
00555-000,../../DataSet/ASNR-MICCAI-BraTS2023-GLI-Challenge-TrainingData/BraTS-GLI-00555-000/BraTS-GLI-00555-000-t1c.nii.gz,../../DataSet/ASNR-MICCAI-BraTS2023-GLI-Challenge-TrainingData/BraTS-GLI-00555-000/BraTS-GLI-00555-000-t2w.nii.gz,../../DataSet/ASNR-MICCAI-BraTS2023-GLI-Challenge-TrainingData/BraTS-GLI-00555-000/BraTS-GLI-00555-000-t2f.nii.gz,../../DataSet/ASNR-MICCAI-BraTS2023-GLI-Challenge-TrainingData/BraTS-GLI-00555-000/BraTS-GLI-00555-000-t1n.nii.gz,../../DataSet/ASNR-MICCAI-BraTS2023-GLI-Challenge-TrainingData/BraTS-GLI-00555-000/BraTS-GLI-00555-000-seg.nii.gz,139,172,83,115,162,141,199,62,112,47,58,50
01315-000,../../DataSet/ASNR-MICCAI-BraTS2023-GLI-Challenge-TrainingData/BraTS-GLI-01315-000/BraTS-GLI-01315-000-t1c.nii.gz,../../DataSet/ASNR-MICCAI-BraTS2023-GLI-Challenge-TrainingData/BraTS-GLI-01315-000/BraTS-GLI-01315-000-t2w.nii.gz,../../DataSet/ASNR-MICCAI-BraTS2023-GLI-Challenge-TrainingData/BraTS-GLI-01315-000/BraTS-GLI-01315-000-t2f.nii.gz,../../DataSet/ASNR-MICCAI-BraTS2023-GLI-Challenge-TrainingData/BraTS-GLI-01315-000/BraTS-GLI-01315-000-t1n.nii.gz,../../DataSet/ASNR-MICCAI-BraTS2023-GLI-Challenge-TrainingData/BraTS-GLI-01315-000/BraTS-GLI-01315-000-seg.nii.gz,150,116,86,123,180,74,161,54,120,57,87,66
00134-000,../../DataSet/ASNR-MICCAI-BraTS2023-GLI-Challenge-TrainingData/BraTS-GLI-00134-000/BraTS-GLI-00134-000-t1c.nii.gz,../../DataSet/ASNR-MICCAI-BraTS2023-GLI-Challenge-TrainingData/BraTS-GLI-00134-000/BraTS-GLI-00134-000-t2w.nii.gz,../../DataSet/ASNR-MICCAI-BraTS2023-GLI-Challenge-TrainingData/BraTS-GLI-00134-000/BraTS-GLI-00134-000-t2f.nii.gz,../../DataSet/ASNR-MICCAI-BraTS2023-GLI-Challenge-TrainingData/BraTS-GLI-00134-000/BraTS-GLI-00134-000-t1n.nii.gz,../../DataSet/ASNR-MICCAI-BraTS2023-GLI-Challenge-TrainingData/BraTS-GLI-00134-000/BraTS-GLI-00134-000-seg.nii.gz,137,94,69,103,174,53,136,30,105,71,83,75
00649-001,../../DataSet/ASNR-MICCAI-BraTS2023-GLI-Challenge-TrainingData/BraTS-GLI-00649-001/BraTS-GLI-00649-001-t1c.nii.gz,../../DataSet/ASNR-MICCAI-BraTS2023-GLI-Challenge-TrainingData/BraTS-GLI-00649-001/BraTS-GLI-00649-001-t2w.nii.gz,../../DataSet/ASNR-MICCAI-BraTS2023-GLI-Challenge-TrainingData/BraTS-GLI-00649-001/BraTS-GLI-00649-001-t2f.nii.gz,../../DataSet/ASNR-MICCAI-BraTS2023-GLI-Challenge-TrainingData/BraTS-GLI-00649-001/BraTS-GLI-00649-001-t1n.nii.gz,../../DataSet/ASNR-MICCAI-BraTS2023-GLI-Challenge-TrainingData/BraTS-GLI-00649-001/BraTS-GLI-00649-001-seg.nii.gz,147,153,101,123,177,118,193,64,137,54,75,73
00199-000,../../DataSet/ASNR-MICCAI-BraTS2023-GLI-Challenge-TrainingData/BraTS-GLI-00199-000/BraTS-GLI-00199-000-t1c.nii.gz,../../DataSet/ASNR-MICCAI-BraTS2023-GLI-Challenge-TrainingData/BraTS-GLI-00199-000/BraTS-GLI-00199-000-t2w.nii.gz,../../DataSet/ASNR-MICCAI-BraTS2023-GLI-Challenge-TrainingData/BraTS-GLI-00199-000/BraTS-GLI-00199-000-t2f.nii.gz,../../DataSet/ASNR-MICCAI-BraTS2023-GLI-Challenge-TrainingData/BraTS-GLI-00199-000/BraTS-GLI-00199-000-t1n.nii.gz,../../DataSet/ASNR-MICCAI-BraTS2023-GLI-Challenge-TrainingData/BraTS-GLI-00199-000/BraTS-GLI-00199-000-seg.nii.gz,133,125,98,72,160,88,171,75,132,88,83,57
00529-000,../../DataSet/ASNR-MICCAI-BraTS2023-GLI-Challenge-TrainingData/BraTS-GLI-00529-000/BraTS-GLI-00529-000-t1c.nii.gz,../../DataSet/ASNR-MICCAI-BraTS2023-GLI-Challenge-TrainingData/BraTS-GLI-00529-000/BraTS-GLI-00529-000-t2w.nii.gz,../../DataSet/ASNR-MICCAI-BraTS2023-GLI-Challenge-TrainingData/BraTS-GLI-00529-000/BraTS-GLI-00529-000-t2f.nii.gz,../../DataSet/ASNR-MICCAI-BraTS2023-GLI-Challenge-TrainingData/BraTS-GLI-00529-000/BraTS-GLI-00529-000-t1n.nii.gz,../../DataSet/ASNR-MICCAI-BraTS2023-GLI-Challenge-TrainingData/BraTS-GLI-00529-000/BraTS-GLI-00529-000-seg.nii.gz,163,92,82,139,184,60,124,59,109,45,64,50
01369-000,../../DataSet/ASNR-MICCAI-BraTS2023-GLI-Challenge-TrainingData/BraTS-GLI-01369-000/BraTS-GLI-01369-000-t1c.nii.gz,../../DataSet/ASNR-MICCAI-BraTS2023-GLI-Challenge-TrainingData/BraTS-GLI-01369-000/BraTS-GLI-01369-000-t2w.nii.gz,../../DataSet/ASNR-MICCAI-BraTS2023-GLI-Challenge-TrainingData/BraTS-GLI-01369-000/BraTS-GLI-01369-000-t2f.nii.gz,../../DataSet/ASNR-MICCAI-BraTS2023-GLI-Challenge-TrainingData/BraTS-GLI-01369-000/BraTS-GLI-01369-000-t1n.nii.gz,../../DataSet/ASNR-MICCAI-BraTS2023-GLI-Challenge-TrainingData/BraTS-GLI-01369-000/BraTS-GLI-01369-000-seg.nii.gz,158,150,101,121,186,109,179,74,140,65,70,66
00148-000,../../DataSet/ASNR-MICCAI-BraTS2023-GLI-Challenge-TrainingData/BraTS-GLI-00148-000/BraTS-GLI-00148-000-t1c.nii.gz,../../DataSet/ASNR-MICCAI-BraTS2023-GLI-Challenge-TrainingData/BraTS-GLI-00148-000/BraTS-GLI-00148-000-t2w.nii.gz,../../DataSet/ASNR-MICCAI-BraTS2023-GLI-Challenge-TrainingData/BraTS-GLI-00148-000/BraTS-GLI-00148-000-t2f.nii.gz,../../DataSet/ASNR-MICCAI-BraTS2023-GLI-Challenge-TrainingData/BraTS-GLI-00148-000/BraTS-GLI-00148-000-t1n.nii.gz,../../DataSet/ASNR-MICCAI-BraTS2023-GLI-Challenge-TrainingData/BraTS-GLI-00148-000/BraTS-GLI-00148-000-seg.nii.gz,164,122,52,135,185,85,168,26,74,50,83,48
01231-000,../../DataSet/ASNR-MICCAI-BraTS2023-GLI-Challenge-TrainingData/BraTS-GLI-01231-000/BraTS-GLI-01231-000-t1c.nii.gz,../../DataSet/ASNR-MICCAI-BraTS2023-GLI-Challenge-TrainingData/BraTS-GLI-01231-000/BraTS-GLI-01231-000-t2w.nii.gz,../../DataSet/ASNR-MICCAI-BraTS2023-GLI-Challenge-TrainingData/BraTS-GLI-01231-000/BraTS-GLI-01231-000-t2f.nii.gz,../../DataSet/ASNR-MICCAI-BraTS2023-GLI-Challenge-TrainingData/BraTS-GLI-01231-000/BraTS-GLI-01231-000-t1n.nii.gz,../../DataSet/ASNR-MICCAI-BraTS2023-GLI-Challenge-TrainingData/BraTS-GLI-01231-000/BraTS-GLI-01231-000-seg.nii.gz,82,143,78,58,107,98,185,48,112,49,87,64
01126-000,../../DataSet/ASNR-MICCAI-BraTS2023-GLI-Challenge-TrainingData/BraTS-GLI-01126-000/BraTS-GLI-01126-000-t1c.nii.gz,../../DataSet/ASNR-MICCAI-BraTS2023-GLI-Challenge-TrainingData/BraTS-GLI-01126-000/BraTS-GLI-01126-000-t2w.nii.gz,../../DataSet/ASNR-MICCAI-BraTS2023-GLI-Challenge-TrainingData/BraTS-GLI-01126-000/BraTS-GLI-01126-000-t2f.nii.gz,../../DataSet/ASNR-MICCAI-BraTS2023-GLI-Challenge-TrainingData/BraTS-GLI-01126-000/BraTS-GLI-01126-000-t1n.nii.gz,../../DataSet/ASNR-MICCAI-BraTS2023-GLI-Challenge-TrainingData/BraTS-GLI-01126-000/BraTS-GLI-01126-000-seg.nii.gz,88,172,76,60,116,142,203,44,112,56,61,68
00101-000,../../DataSet/ASNR-MICCAI-BraTS2023-GLI-Challenge-TrainingData/BraTS-GLI-00101-000/BraTS-GLI-00101-000-t1c.nii.gz,../../DataSet/ASNR-MICCAI-BraTS2023-GLI-Challenge-TrainingData/BraTS-GLI-00101-000/BraTS-GLI-00101-000-t2w.nii.gz,../../DataSet/ASNR-MICCAI-BraTS2023-GLI-Challenge-TrainingData/BraTS-GLI-00101-000/BraTS-GLI-00101-000-t2f.nii.gz,../../DataSet/ASNR-MICCAI-BraTS2023-GLI-Challenge-TrainingData/BraTS-GLI-00101-000/BraTS-GLI-00101-000-t1n.nii.gz,../../DataSet/ASNR-MICCAI-BraTS2023-GLI-Challenge-TrainingData/BraTS-GLI-00101-000/BraTS-GLI-00101-000-seg.nii.gz,150,159,98,126,177,136,183,68,125,51,47,57
01487-000,../../DataSet/ASNR-MICCAI-BraTS2023-GLI-Challenge-TrainingData/BraTS-GLI-01487-000/BraTS-GLI-01487-000-t1c.nii.gz,../../DataSet/ASNR-MICCAI-BraTS2023-GLI-Challenge-TrainingData/BraTS-GLI-01487-000/BraTS-GLI-01487-000-t2w.nii.gz,../../DataSet/ASNR-MICCAI-BraTS2023-GLI-Challenge-TrainingData/BraTS-GLI-01487-000/BraTS-GLI-01487-000-t2f.nii.gz,../../DataSet/ASNR-MICCAI-BraTS2023-GLI-Challenge-TrainingData/BraTS-GLI-01487-000/BraTS-GLI-01487-000-t1n.nii.gz,../../DataSet/ASNR-MICCAI-BraTS2023-GLI-Challenge-TrainingData/BraTS-GLI-01487-000/BraTS-GLI-01487-000-seg.nii.gz,92,111,64,67,128,83,148,31,95,61,65,64
01456-000,../../DataSet/ASNR-MICCAI-BraTS2023-GLI-Challenge-TrainingData/BraTS-GLI-01456-000/BraTS-GLI-01456-000-t1c.nii.gz,../../DataSet/ASNR-MICCAI-BraTS2023-GLI-Challenge-TrainingData/BraTS-GLI-01456-000/BraTS-GLI-01456-000-t2w.nii.gz,../../DataSet/ASNR-MICCAI-BraTS2023-GLI-Challenge-TrainingData/BraTS-GLI-01456-000/BraTS-GLI-01456-000-t2f.nii.gz,../../DataSet/ASNR-MICCAI-BraTS2023-GLI-Challenge-TrainingData/BraTS-GLI-01456-000/BraTS-GLI-01456-000-t1n.nii.gz,../../DataSet/ASNR-MICCAI-BraTS2023-GLI-Challenge-TrainingData/BraTS-GLI-01456-000/BraTS-GLI-01456-000-seg.nii.gz,84,130,69,57,116,91,171,40,99,59,80,59
00088-000,../../DataSet/ASNR-MICCAI-BraTS2023-GLI-Challenge-TrainingData/BraTS-GLI-00088-000/BraTS-GLI-00088-000-t1c.nii.gz,../../DataSet/ASNR-MICCAI-BraTS2023-GLI-Challenge-TrainingData/BraTS-GLI-00088-000/BraTS-GLI-00088-000-t2w.nii.gz,../../DataSet/ASNR-MICCAI-BraTS2023-GLI-Challenge-TrainingData/BraTS-GLI-00088-000/BraTS-GLI-00088-000-t2f.nii.gz,../../DataSet/ASNR-MICCAI-BraTS2023-GLI-Challenge-TrainingData/BraTS-GLI-00088-000/BraTS-GLI-00088-000-t1n.nii.gz,../../DataSet/ASNR-MICCAI-BraTS2023-GLI-Challenge-TrainingData/BraTS-GLI-00088-000/BraTS-GLI-00088-000-seg.nii.gz,96,158,86,63,131,126,195,54,124,68,69,70
01278-000,../../DataSet/ASNR-MICCAI-BraTS2023-GLI-Challenge-TrainingData/BraTS-GLI-01278-000/BraTS-GLI-01278-000-t1c.nii.gz,../../DataSet/ASNR-MICCAI-BraTS2023-GLI-Challenge-TrainingData/BraTS-GLI-01278-000/BraTS-GLI-01278-000-t2w.nii.gz,../../DataSet/ASNR-MICCAI-BraTS2023-GLI-Challenge-TrainingData/BraTS-GLI-01278-000/BraTS-GLI-01278-000-t2f.nii.gz,../../DataSet/ASNR-MICCAI-BraTS2023-GLI-Challenge-TrainingData/BraTS-GLI-01278-000/BraTS-GLI-01278-000-t1n.nii.gz,../../DataSet/ASNR-MICCAI-BraTS2023-GLI-Challenge-TrainingData/BraTS-GLI-01278-000/BraTS-GLI-01278-000-seg.nii.gz,138,149,88,114,169,98,178,52,114,55,80,62
00495-000,../../DataSet/ASNR-MICCAI-BraTS2023-GLI-Challenge-TrainingData/BraTS-GLI-00495-000/BraTS-GLI-00495-000-t1c.nii.gz,../../DataSet/ASNR-MICCAI-BraTS2023-GLI-Challenge-TrainingData/BraTS-GLI-00495-000/BraTS-GLI-00495-000-t2w.nii.gz,../../DataSet/ASNR-MICCAI-BraTS2023-GLI-Challenge-TrainingData/BraTS-GLI-00495-000/BraTS-GLI-00495-000-t2f.nii.gz,../../DataSet/ASNR-MICCAI-BraTS2023-GLI-Challenge-TrainingData/BraTS-GLI-00495-000/BraTS-GLI-00495-000-t1n.nii.gz,../../DataSet/ASNR-MICCAI-BraTS2023-GLI-Challenge-TrainingData/BraTS-GLI-00495-000/BraTS-GLI-00495-000-seg.nii.gz,98,164,98,74,123,126,205,67,136,49,79,69
00332-000,../../DataSet/ASNR-MICCAI-BraTS2023-GLI-Challenge-TrainingData/BraTS-GLI-00332-000/BraTS-GLI-00332-000-t1c.nii.gz,../../DataSet/ASNR-MICCAI-BraTS2023-GLI-Challenge-TrainingData/BraTS-GLI-00332-000/BraTS-GLI-00332-000-t2w.nii.gz,../../DataSet/ASNR-MICCAI-BraTS2023-GLI-Challenge-TrainingData/BraTS-GLI-00332-000/BraTS-GLI-00332-000-t2f.nii.gz,../../DataSet/ASNR-MICCAI-BraTS2023-GLI-Challenge-TrainingData/BraTS-GLI-00332-000/BraTS-GLI-00332-000-t1n.nii.gz,../../DataSet/ASNR-MICCAI-BraTS2023-GLI-Challenge-TrainingData/BraTS-GLI-00332-000/BraTS-GLI-00332-000-seg.nii.gz,104,114,115,76,128,92,138,94,137,52,46,43
00517-001,../../DataSet/ASNR-MICCAI-BraTS2023-GLI-Challenge-TrainingData/BraTS-GLI-00517-001/BraTS-GLI-00517-001-t1c.nii.gz,../../DataSet/ASNR-MICCAI-BraTS2023-GLI-Challenge-TrainingData/BraTS-GLI-00517-001/BraTS-GLI-00517-001-t2w.nii.gz,../../DataSet/ASNR-MICCAI-BraTS2023-GLI-Challenge-TrainingData/BraTS-GLI-00517-001/BraTS-GLI-00517-001-t2f.nii.gz,../../DataSet/ASNR-MICCAI-BraTS2023-GLI-Challenge-TrainingData/BraTS-GLI-00517-001/BraTS-GLI-00517-001-t1n.nii.gz,../../DataSet/ASNR-MICCAI-BraTS2023-GLI-Challenge-TrainingData/BraTS-GLI-00517-001/BraTS-GLI-00517-001-seg.nii.gz,93,159,80,60,143,117,202,46,121,83,85,75
00025-000,../../DataSet/ASNR-MICCAI-BraTS2023-GLI-Challenge-TrainingData/BraTS-GLI-00025-000/BraTS-GLI-00025-000-t1c.nii.gz,../../DataSet/ASNR-MICCAI-BraTS2023-GLI-Challenge-TrainingData/BraTS-GLI-00025-000/BraTS-GLI-00025-000-t2w.nii.gz,../../DataSet/ASNR-MICCAI-BraTS2023-GLI-Challenge-TrainingData/BraTS-GLI-00025-000/BraTS-GLI-00025-000-t2f.nii.gz,../../DataSet/ASNR-MICCAI-BraTS2023-GLI-Challenge-TrainingData/BraTS-GLI-00025-000/BraTS-GLI-00025-000-t1n.nii.gz,../../DataSet/ASNR-MICCAI-BraTS2023-GLI-Challenge-TrainingData/BraTS-GLI-00025-000/BraTS-GLI-00025-000-seg.nii.gz,173,155,71,155,190,123,188,48,109,35,65,61
00782-000,../../DataSet/ASNR-MICCAI-BraTS2023-GLI-Challenge-TrainingData/BraTS-GLI-00782-000/BraTS-GLI-00782-000-t1c.nii.gz,../../DataSet/ASNR-MICCAI-BraTS2023-GLI-Challenge-TrainingData/BraTS-GLI-00782-000/BraTS-GLI-00782-000-t2w.nii.gz,../../DataSet/ASNR-MICCAI-BraTS2023-GLI-Challenge-TrainingData/BraTS-GLI-00782-000/BraTS-GLI-00782-000-t2f.nii.gz,../../DataSet/ASNR-MICCAI-BraTS2023-GLI-Challenge-TrainingData/BraTS-GLI-00782-000/BraTS-GLI-00782-000-t1n.nii.gz,../../DataSet/ASNR-MICCAI-BraTS2023-GLI-Challenge-TrainingData/BraTS-GLI-00782-000/BraTS-GLI-00782-000-seg.nii.gz,93,152,105,74,115,130,176,84,131,41,46,47
00444-000,../../DataSet/ASNR-MICCAI-BraTS2023-GLI-Challenge-TrainingData/BraTS-GLI-00444-000/BraTS-GLI-00444-000-t1c.nii.gz,../../DataSet/ASNR-MICCAI-BraTS2023-GLI-Challenge-TrainingData/BraTS-GLI-00444-000/BraTS-GLI-00444-000-t2w.nii.gz,../../DataSet/ASNR-MICCAI-BraTS2023-GLI-Challenge-TrainingData/BraTS-GLI-00444-000/BraTS-GLI-00444-000-t2f.nii.gz,../../DataSet/ASNR-MICCAI-BraTS2023-GLI-Challenge-TrainingData/BraTS-GLI-00444-000/BraTS-GLI-00444-000-t1n.nii.gz,../../DataSet/ASNR-MICCAI-BraTS2023-GLI-Challenge-TrainingData/BraTS-GLI-00444-000/BraTS-GLI-00444-000-seg.nii.gz,135,146,64,115,155,128,163,44,90,40,35,46
00836-000,../../DataSet/ASNR-MICCAI-BraTS2023-GLI-Challenge-TrainingData/BraTS-GLI-00836-000/BraTS-GLI-00836-000-t1c.nii.gz,../../DataSet/ASNR-MICCAI-BraTS2023-GLI-Challenge-TrainingData/BraTS-GLI-00836-000/BraTS-GLI-00836-000-t2w.nii.gz,../../DataSet/ASNR-MICCAI-BraTS2023-GLI-Challenge-TrainingData/BraTS-GLI-00836-000/BraTS-GLI-00836-000-t2f.nii.gz,../../DataSet/ASNR-MICCAI-BraTS2023-GLI-Challenge-TrainingData/BraTS-GLI-00836-000/BraTS-GLI-00836-000-t1n.nii.gz,../../DataSet/ASNR-MICCAI-BraTS2023-GLI-Challenge-TrainingData/BraTS-GLI-00836-000/BraTS-GLI-00836-000-seg.nii.gz,142,153,58,127,160,127,183,45,76,33,56,31
01204-000,../../DataSet/ASNR-MICCAI-BraTS2023-GLI-Challenge-TrainingData/BraTS-GLI-01204-000/BraTS-GLI-01204-000-t1c.nii.gz,../../DataSet/ASNR-MICCAI-BraTS2023-GLI-Challenge-TrainingData/BraTS-GLI-01204-000/BraTS-GLI-01204-000-t2w.nii.gz,../../DataSet/ASNR-MICCAI-BraTS2023-GLI-Challenge-TrainingData/BraTS-GLI-01204-000/BraTS-GLI-01204-000-t2f.nii.gz,../../DataSet/ASNR-MICCAI-BraTS2023-GLI-Challenge-TrainingData/BraTS-GLI-01204-000/BraTS-GLI-01204-000-t1n.nii.gz,../../DataSet/ASNR-MICCAI-BraTS2023-GLI-Challenge-TrainingData/BraTS-GLI-01204-000/BraTS-GLI-01204-000-seg.nii.gz,152,154,85,126,181,121,184,59,110,55,63,51
00510-001,../../DataSet/ASNR-MICCAI-BraTS2023-GLI-Challenge-TrainingData/BraTS-GLI-00510-001/BraTS-GLI-00510-001-t1c.nii.gz,../../DataSet/ASNR-MICCAI-BraTS2023-GLI-Challenge-TrainingData/BraTS-GLI-00510-001/BraTS-GLI-00510-001-t2w.nii.gz,../../DataSet/ASNR-MICCAI-BraTS2023-GLI-Challenge-TrainingData/BraTS-GLI-00510-001/BraTS-GLI-00510-001-t2f.nii.gz,../../DataSet/ASNR-MICCAI-BraTS2023-GLI-Challenge-TrainingData/BraTS-GLI-00510-001/BraTS-GLI-00510-001-t1n.nii.gz,../../DataSet/ASNR-MICCAI-BraTS2023-GLI-Challenge-TrainingData/BraTS-GLI-00510-001/BraTS-GLI-00510-001-seg.nii.gz,156,148,54,123,179,115,193,33,78,56,78,45
01114-000,../../DataSet/ASNR-MICCAI-BraTS2023-GLI-Challenge-TrainingData/BraTS-GLI-01114-000/BraTS-GLI-01114-000-t1c.nii.gz,../../DataSet/ASNR-MICCAI-BraTS2023-GLI-Challenge-TrainingData/BraTS-GLI-01114-000/BraTS-GLI-01114-000-t2w.nii.gz,../../DataSet/ASNR-MICCAI-BraTS2023-GLI-Challenge-TrainingData/BraTS-GLI-01114-000/BraTS-GLI-01114-000-t2f.nii.gz,../../DataSet/ASNR-MICCAI-BraTS2023-GLI-Challenge-TrainingData/BraTS-GLI-01114-000/BraTS-GLI-01114-000-t1n.nii.gz,../../DataSet/ASNR-MICCAI-BraTS2023-GLI-Challenge-TrainingData/BraTS-GLI-01114-000/BraTS-GLI-01114-000-seg.nii.gz,157,123,68,131,180,84,172,39,100,49,88,61
00022-000,../../DataSet/ASNR-MICCAI-BraTS2023-GLI-Challenge-TrainingData/BraTS-GLI-00022-000/BraTS-GLI-00022-000-t1c.nii.gz,../../DataSet/ASNR-MICCAI-BraTS2023-GLI-Challenge-TrainingData/BraTS-GLI-00022-000/BraTS-GLI-00022-000-t2w.nii.gz,../../DataSet/ASNR-MICCAI-BraTS2023-GLI-Challenge-TrainingData/BraTS-GLI-00022-000/BraTS-GLI-00022-000-t2f.nii.gz,../../DataSet/ASNR-MICCAI-BraTS2023-GLI-Challenge-TrainingData/BraTS-GLI-00022-000/BraTS-GLI-00022-000-t1n.nii.gz,../../DataSet/ASNR-MICCAI-BraTS2023-GLI-Challenge-TrainingData/BraTS-GLI-00022-000/BraTS-GLI-00022-000-seg.nii.gz,91,157,98,62,121,122,195,61,139,59,73,78
01662-000,../../DataSet/ASNR-MICCAI-BraTS2023-GLI-Challenge-TrainingData/BraTS-GLI-01662-000/BraTS-GLI-01662-000-t1c.nii.gz,../../DataSet/ASNR-MICCAI-BraTS2023-GLI-Challenge-TrainingData/BraTS-GLI-01662-000/BraTS-GLI-01662-000-t2w.nii.gz,../../DataSet/ASNR-MICCAI-BraTS2023-GLI-Challenge-TrainingData/BraTS-GLI-01662-000/BraTS-GLI-01662-000-t2f.nii.gz,../../DataSet/ASNR-MICCAI-BraTS2023-GLI-Challenge-TrainingData/BraTS-GLI-01662-000/BraTS-GLI-01662-000-t1n.nii.gz,../../DataSet/ASNR-MICCAI-BraTS2023-GLI-Challenge-TrainingData/BraTS-GLI-01662-000/BraTS-GLI-01662-000-seg.nii.gz,98,108,105,67,120,63,154,78,133,53,91,55
01203-000,../../DataSet/ASNR-MICCAI-BraTS2023-GLI-Challenge-TrainingData/BraTS-GLI-01203-000/BraTS-GLI-01203-000-t1c.nii.gz,../../DataSet/ASNR-MICCAI-BraTS2023-GLI-Challenge-TrainingData/BraTS-GLI-01203-000/BraTS-GLI-01203-000-t2w.nii.gz,../../DataSet/ASNR-MICCAI-BraTS2023-GLI-Challenge-TrainingData/BraTS-GLI-01203-000/BraTS-GLI-01203-000-t2f.nii.gz,../../DataSet/ASNR-MICCAI-BraTS2023-GLI-Challenge-TrainingData/BraTS-GLI-01203-000/BraTS-GLI-01203-000-t1n.nii.gz,../../DataSet/ASNR-MICCAI-BraTS2023-GLI-Challenge-TrainingData/BraTS-GLI-01203-000/BraTS-GLI-01203-000-seg.nii.gz,83,112,56,56,116,81,170,28,82,60,89,54
00831-000,../../DataSet/ASNR-MICCAI-BraTS2023-GLI-Challenge-TrainingData/BraTS-GLI-00831-000/BraTS-GLI-00831-000-t1c.nii.gz,../../DataSet/ASNR-MICCAI-BraTS2023-GLI-Challenge-TrainingData/BraTS-GLI-00831-000/BraTS-GLI-00831-000-t2w.nii.gz,../../DataSet/ASNR-MICCAI-BraTS2023-GLI-Challenge-TrainingData/BraTS-GLI-00831-000/BraTS-GLI-00831-000-t2f.nii.gz,../../DataSet/ASNR-MICCAI-BraTS2023-GLI-Challenge-TrainingData/BraTS-GLI-00831-000/BraTS-GLI-00831-000-t1n.nii.gz,../../DataSet/ASNR-MICCAI-BraTS2023-GLI-Challenge-TrainingData/BraTS-GLI-00831-000/BraTS-GLI-00831-000-seg.nii.gz,147,112,92,127,172,83,142,63,117,45,59,54
00443-000,../../DataSet/ASNR-MICCAI-BraTS2023-GLI-Challenge-TrainingData/BraTS-GLI-00443-000/BraTS-GLI-00443-000-t1c.nii.gz,../../DataSet/ASNR-MICCAI-BraTS2023-GLI-Challenge-TrainingData/BraTS-GLI-00443-000/BraTS-GLI-00443-000-t2w.nii.gz,../../DataSet/ASNR-MICCAI-BraTS2023-GLI-Challenge-TrainingData/BraTS-GLI-00443-000/BraTS-GLI-00443-000-t2f.nii.gz,../../DataSet/ASNR-MICCAI-BraTS2023-GLI-Challenge-TrainingData/BraTS-GLI-00443-000/BraTS-GLI-00443-000-t1n.nii.gz,../../DataSet/ASNR-MICCAI-BraTS2023-GLI-Challenge-TrainingData/BraTS-GLI-00443-000/BraTS-GLI-00443-000-seg.nii.gz,104,170,88,80,133,132,207,50,128,53,75,78
00084-001,../../DataSet/ASNR-MICCAI-BraTS2023-GLI-Challenge-TrainingData/BraTS-GLI-00084-001/BraTS-GLI-00084-001-t1c.nii.gz,../../DataSet/ASNR-MICCAI-BraTS2023-GLI-Challenge-TrainingData/BraTS-GLI-00084-001/BraTS-GLI-00084-001-t2w.nii.gz,../../DataSet/ASNR-MICCAI-BraTS2023-GLI-Challenge-TrainingData/BraTS-GLI-00084-001/BraTS-GLI-00084-001-t2f.nii.gz,../../DataSet/ASNR-MICCAI-BraTS2023-GLI-Challenge-TrainingData/BraTS-GLI-00084-001/BraTS-GLI-00084-001-t1n.nii.gz,../../DataSet/ASNR-MICCAI-BraTS2023-GLI-Challenge-TrainingData/BraTS-GLI-00084-001/BraTS-GLI-00084-001-seg.nii.gz,80,134,88,59,105,95,176,62,112,46,81,50
01327-000,../../DataSet/ASNR-MICCAI-BraTS2023-GLI-Challenge-TrainingData/BraTS-GLI-01327-000/BraTS-GLI-01327-000-t1c.nii.gz,../../DataSet/ASNR-MICCAI-BraTS2023-GLI-Challenge-TrainingData/BraTS-GLI-01327-000/BraTS-GLI-01327-000-t2w.nii.gz,../../DataSet/ASNR-MICCAI-BraTS2023-GLI-Challenge-TrainingData/BraTS-GLI-01327-000/BraTS-GLI-01327-000-t2f.nii.gz,../../DataSet/ASNR-MICCAI-BraTS2023-GLI-Challenge-TrainingData/BraTS-GLI-01327-000/BraTS-GLI-01327-000-t1n.nii.gz,../../DataSet/ASNR-MICCAI-BraTS2023-GLI-Challenge-TrainingData/BraTS-GLI-01327-000/BraTS-GLI-01327-000-seg.nii.gz,174,133,62,158,189,121,148,51,77,31,27,26
01480-000,../../DataSet/ASNR-MICCAI-BraTS2023-GLI-Challenge-TrainingData/BraTS-GLI-01480-000/BraTS-GLI-01480-000-t1c.nii.gz,../../DataSet/ASNR-MICCAI-BraTS2023-GLI-Challenge-TrainingData/BraTS-GLI-01480-000/BraTS-GLI-01480-000-t2w.nii.gz,../../DataSet/ASNR-MICCAI-BraTS2023-GLI-Challenge-TrainingData/BraTS-GLI-01480-000/BraTS-GLI-01480-000-t2f.nii.gz,../../DataSet/ASNR-MICCAI-BraTS2023-GLI-Challenge-TrainingData/BraTS-GLI-01480-000/BraTS-GLI-01480-000-t1n.nii.gz,../../DataSet/ASNR-MICCAI-BraTS2023-GLI-Challenge-TrainingData/BraTS-GLI-01480-000/BraTS-GLI-01480-000-seg.nii.gz,147,127,53,124,176,93,165,31,74,52,72,43
00567-000,../../DataSet/ASNR-MICCAI-BraTS2023-GLI-Challenge-TrainingData/BraTS-GLI-00567-000/BraTS-GLI-00567-000-t1c.nii.gz,../../DataSet/ASNR-MICCAI-BraTS2023-GLI-Challenge-TrainingData/BraTS-GLI-00567-000/BraTS-GLI-00567-000-t2w.nii.gz,../../DataSet/ASNR-MICCAI-BraTS2023-GLI-Challenge-TrainingData/BraTS-GLI-00567-000/BraTS-GLI-00567-000-t2f.nii.gz,../../DataSet/ASNR-MICCAI-BraTS2023-GLI-Challenge-TrainingData/BraTS-GLI-00567-000/BraTS-GLI-00567-000-t1n.nii.gz,../../DataSet/ASNR-MICCAI-BraTS2023-GLI-Challenge-TrainingData/BraTS-GLI-00567-000/BraTS-GLI-00567-000-seg.nii.gz,153,178,76,137,175,153,207,51,104,38,54,53
00211-000,../../DataSet/ASNR-MICCAI-BraTS2023-GLI-Challenge-TrainingData/BraTS-GLI-00211-000/BraTS-GLI-00211-000-t1c.nii.gz,../../DataSet/ASNR-MICCAI-BraTS2023-GLI-Challenge-TrainingData/BraTS-GLI-00211-000/BraTS-GLI-00211-000-t2w.nii.gz,../../DataSet/ASNR-MICCAI-BraTS2023-GLI-Challenge-TrainingData/BraTS-GLI-00211-000/BraTS-GLI-00211-000-t2f.nii.gz,../../DataSet/ASNR-MICCAI-BraTS2023-GLI-Challenge-TrainingData/BraTS-GLI-00211-000/BraTS-GLI-00211-000-t1n.nii.gz,../../DataSet/ASNR-MICCAI-BraTS2023-GLI-Challenge-TrainingData/BraTS-GLI-00211-000/BraTS-GLI-00211-000-seg.nii.gz,142,165,89,117,176,128,207,50,134,59,79,84
01451-000,../../DataSet/ASNR-MICCAI-BraTS2023-GLI-Challenge-TrainingData/BraTS-GLI-01451-000/BraTS-GLI-01451-000-t1c.nii.gz,../../DataSet/ASNR-MICCAI-BraTS2023-GLI-Challenge-TrainingData/BraTS-GLI-01451-000/BraTS-GLI-01451-000-t2w.nii.gz,../../DataSet/ASNR-MICCAI-BraTS2023-GLI-Challenge-TrainingData/BraTS-GLI-01451-000/BraTS-GLI-01451-000-t2f.nii.gz,../../DataSet/ASNR-MICCAI-BraTS2023-GLI-Challenge-TrainingData/BraTS-GLI-01451-000/BraTS-GLI-01451-000-t1n.nii.gz,../../DataSet/ASNR-MICCAI-BraTS2023-GLI-Challenge-TrainingData/BraTS-GLI-01451-000/BraTS-GLI-01451-000-seg.nii.gz,70,114,57,54,88,91,138,40,75,34,47,35
01030-000,../../DataSet/ASNR-MICCAI-BraTS2023-GLI-Challenge-TrainingData/BraTS-GLI-01030-000/BraTS-GLI-01030-000-t1c.nii.gz,../../DataSet/ASNR-MICCAI-BraTS2023-GLI-Challenge-TrainingData/BraTS-GLI-01030-000/BraTS-GLI-01030-000-t2w.nii.gz,../../DataSet/ASNR-MICCAI-BraTS2023-GLI-Challenge-TrainingData/BraTS-GLI-01030-000/BraTS-GLI-01030-000-t2f.nii.gz,../../DataSet/ASNR-MICCAI-BraTS2023-GLI-Challenge-TrainingData/BraTS-GLI-01030-000/BraTS-GLI-01030-000-t1n.nii.gz,../../DataSet/ASNR-MICCAI-BraTS2023-GLI-Challenge-TrainingData/BraTS-GLI-01030-000/BraTS-GLI-01030-000-seg.nii.gz,83,128,61,54,121,85,179,28,96,67,94,68
00349-000,../../DataSet/ASNR-MICCAI-BraTS2023-GLI-Challenge-TrainingData/BraTS-GLI-00349-000/BraTS-GLI-00349-000-t1c.nii.gz,../../DataSet/ASNR-MICCAI-BraTS2023-GLI-Challenge-TrainingData/BraTS-GLI-00349-000/BraTS-GLI-00349-000-t2w.nii.gz,../../DataSet/ASNR-MICCAI-BraTS2023-GLI-Challenge-TrainingData/BraTS-GLI-00349-000/BraTS-GLI-00349-000-t2f.nii.gz,../../DataSet/ASNR-MICCAI-BraTS2023-GLI-Challenge-TrainingData/BraTS-GLI-00349-000/BraTS-GLI-00349-000-t1n.nii.gz,../../DataSet/ASNR-MICCAI-BraTS2023-GLI-Challenge-TrainingData/BraTS-GLI-00349-000/BraTS-GLI-00349-000-seg.nii.gz,80,124,64,56,110,83,167,33,91,54,84,58
01509-000,../../DataSet/ASNR-MICCAI-BraTS2023-GLI-Challenge-TrainingData/BraTS-GLI-01509-000/BraTS-GLI-01509-000-t1c.nii.gz,../../DataSet/ASNR-MICCAI-BraTS2023-GLI-Challenge-TrainingData/BraTS-GLI-01509-000/BraTS-GLI-01509-000-t2w.nii.gz,../../DataSet/ASNR-MICCAI-BraTS2023-GLI-Challenge-TrainingData/BraTS-GLI-01509-000/BraTS-GLI-01509-000-t2f.nii.gz,../../DataSet/ASNR-MICCAI-BraTS2023-GLI-Challenge-TrainingData/BraTS-GLI-01509-000/BraTS-GLI-01509-000-t1n.nii.gz,../../DataSet/ASNR-MICCAI-BraTS2023-GLI-Challenge-TrainingData/BraTS-GLI-01509-000/BraTS-GLI-01509-000-seg.nii.gz,93,112,51,75,115,84,146,31,75,40,62,44
01168-000,../../DataSet/ASNR-MICCAI-BraTS2023-GLI-Challenge-TrainingData/BraTS-GLI-01168-000/BraTS-GLI-01168-000-t1c.nii.gz,../../DataSet/ASNR-MICCAI-BraTS2023-GLI-Challenge-TrainingData/BraTS-GLI-01168-000/BraTS-GLI-01168-000-t2w.nii.gz,../../DataSet/ASNR-MICCAI-BraTS2023-GLI-Challenge-TrainingData/BraTS-GLI-01168-000/BraTS-GLI-01168-000-t2f.nii.gz,../../DataSet/ASNR-MICCAI-BraTS2023-GLI-Challenge-TrainingData/BraTS-GLI-01168-000/BraTS-GLI-01168-000-t1n.nii.gz,../../DataSet/ASNR-MICCAI-BraTS2023-GLI-Challenge-TrainingData/BraTS-GLI-01168-000/BraTS-GLI-01168-000-seg.nii.gz,146,110,74,126,172,79,146,46,101,46,67,55
00728-000,../../DataSet/ASNR-MICCAI-BraTS2023-GLI-Challenge-TrainingData/BraTS-GLI-00728-000/BraTS-GLI-00728-000-t1c.nii.gz,../../DataSet/ASNR-MICCAI-BraTS2023-GLI-Challenge-TrainingData/BraTS-GLI-00728-000/BraTS-GLI-00728-000-t2w.nii.gz,../../DataSet/ASNR-MICCAI-BraTS2023-GLI-Challenge-TrainingData/BraTS-GLI-00728-000/BraTS-GLI-00728-000-t2f.nii.gz,../../DataSet/ASNR-MICCAI-BraTS2023-GLI-Challenge-TrainingData/BraTS-GLI-00728-000/BraTS-GLI-00728-000-t1n.nii.gz,../../DataSet/ASNR-MICCAI-BraTS2023-GLI-Challenge-TrainingData/BraTS-GLI-00728-000/BraTS-GLI-00728-000-seg.nii.gz,152,100,73,138,168,75,133,49,95,30,58,46
00751-001,../../DataSet/ASNR-MICCAI-BraTS2023-GLI-Challenge-TrainingData/BraTS-GLI-00751-001/BraTS-GLI-00751-001-t1c.nii.gz,../../DataSet/ASNR-MICCAI-BraTS2023-GLI-Challenge-TrainingData/BraTS-GLI-00751-001/BraTS-GLI-00751-001-t2w.nii.gz,../../DataSet/ASNR-MICCAI-BraTS2023-GLI-Challenge-TrainingData/BraTS-GLI-00751-001/BraTS-GLI-00751-001-t2f.nii.gz,../../DataSet/ASNR-MICCAI-BraTS2023-GLI-Challenge-TrainingData/BraTS-GLI-00751-001/BraTS-GLI-00751-001-t1n.nii.gz,../../DataSet/ASNR-MICCAI-BraTS2023-GLI-Challenge-TrainingData/BraTS-GLI-00751-001/BraTS-GLI-00751-001-seg.nii.gz,138,140,62,115,166,109,182,19,92,51,73,73
01355-000,../../DataSet/ASNR-MICCAI-BraTS2023-GLI-Challenge-TrainingData/BraTS-GLI-01355-000/BraTS-GLI-01355-000-t1c.nii.gz,../../DataSet/ASNR-MICCAI-BraTS2023-GLI-Challenge-TrainingData/BraTS-GLI-01355-000/BraTS-GLI-01355-000-t2w.nii.gz,../../DataSet/ASNR-MICCAI-BraTS2023-GLI-Challenge-TrainingData/BraTS-GLI-01355-000/BraTS-GLI-01355-000-t2f.nii.gz,../../DataSet/ASNR-MICCAI-BraTS2023-GLI-Challenge-TrainingData/BraTS-GLI-01355-000/BraTS-GLI-01355-000-t1n.nii.gz,../../DataSet/ASNR-MICCAI-BraTS2023-GLI-Challenge-TrainingData/BraTS-GLI-01355-000/BraTS-GLI-01355-000-seg.nii.gz,157,120,59,125,182,82,161,24,89,57,79,65
01423-000,../../DataSet/ASNR-MICCAI-BraTS2023-GLI-Challenge-TrainingData/BraTS-GLI-01423-000/BraTS-GLI-01423-000-t1c.nii.gz,../../DataSet/ASNR-MICCAI-BraTS2023-GLI-Challenge-TrainingData/BraTS-GLI-01423-000/BraTS-GLI-01423-000-t2w.nii.gz,../../DataSet/ASNR-MICCAI-BraTS2023-GLI-Challenge-TrainingData/BraTS-GLI-01423-000/BraTS-GLI-01423-000-t2f.nii.gz,../../DataSet/ASNR-MICCAI-BraTS2023-GLI-Challenge-TrainingData/BraTS-GLI-01423-000/BraTS-GLI-01423-000-t1n.nii.gz,../../DataSet/ASNR-MICCAI-BraTS2023-GLI-Challenge-TrainingData/BraTS-GLI-01423-000/BraTS-GLI-01423-000-seg.nii.gz,92,141,104,79,107,126,159,88,123,28,33,35
01384-000,../../DataSet/ASNR-MICCAI-BraTS2023-GLI-Challenge-TrainingData/BraTS-GLI-01384-000/BraTS-GLI-01384-000-t1c.nii.gz,../../DataSet/ASNR-MICCAI-BraTS2023-GLI-Challenge-TrainingData/BraTS-GLI-01384-000/BraTS-GLI-01384-000-t2w.nii.gz,../../DataSet/ASNR-MICCAI-BraTS2023-GLI-Challenge-TrainingData/BraTS-GLI-01384-000/BraTS-GLI-01384-000-t2f.nii.gz,../../DataSet/ASNR-MICCAI-BraTS2023-GLI-Challenge-TrainingData/BraTS-GLI-01384-000/BraTS-GLI-01384-000-t1n.nii.gz,../../DataSet/ASNR-MICCAI-BraTS2023-GLI-Challenge-TrainingData/BraTS-GLI-01384-000/BraTS-GLI-01384-000-seg.nii.gz,154,135,73,125,184,91,183,42,105,59,92,63
00263-000,../../DataSet/ASNR-MICCAI-BraTS2023-GLI-Challenge-TrainingData/BraTS-GLI-00263-000/BraTS-GLI-00263-000-t1c.nii.gz,../../DataSet/ASNR-MICCAI-BraTS2023-GLI-Challenge-TrainingData/BraTS-GLI-00263-000/BraTS-GLI-00263-000-t2w.nii.gz,../../DataSet/ASNR-MICCAI-BraTS2023-GLI-Challenge-TrainingData/BraTS-GLI-00263-000/BraTS-GLI-00263-000-t2f.nii.gz,../../DataSet/ASNR-MICCAI-BraTS2023-GLI-Challenge-TrainingData/BraTS-GLI-00263-000/BraTS-GLI-00263-000-t1n.nii.gz,../../DataSet/ASNR-MICCAI-BraTS2023-GLI-Challenge-TrainingData/BraTS-GLI-00263-000/BraTS-GLI-00263-000-seg.nii.gz,98,126,97,66,132,94,158,59,136,66,64,77
00602-000,../../DataSet/ASNR-MICCAI-BraTS2023-GLI-Challenge-TrainingData/BraTS-GLI-00602-000/BraTS-GLI-00602-000-t1c.nii.gz,../../DataSet/ASNR-MICCAI-BraTS2023-GLI-Challenge-TrainingData/BraTS-GLI-00602-000/BraTS-GLI-00602-000-t2w.nii.gz,../../DataSet/ASNR-MICCAI-BraTS2023-GLI-Challenge-TrainingData/BraTS-GLI-00602-000/BraTS-GLI-00602-000-t2f.nii.gz,../../DataSet/ASNR-MICCAI-BraTS2023-GLI-Challenge-TrainingData/BraTS-GLI-00602-000/BraTS-GLI-00602-000-t1n.nii.gz,../../DataSet/ASNR-MICCAI-BraTS2023-GLI-Challenge-TrainingData/BraTS-GLI-00602-000/BraTS-GLI-00602-000-seg.nii.gz,147,143,95,92,176,108,192,72,116,84,84,44
00108-000,../../DataSet/ASNR-MICCAI-BraTS2023-GLI-Challenge-TrainingData/BraTS-GLI-00108-000/BraTS-GLI-00108-000-t1c.nii.gz,../../DataSet/ASNR-MICCAI-BraTS2023-GLI-Challenge-TrainingData/BraTS-GLI-00108-000/BraTS-GLI-00108-000-t2w.nii.gz,../../DataSet/ASNR-MICCAI-BraTS2023-GLI-Challenge-TrainingData/BraTS-GLI-00108-000/BraTS-GLI-00108-000-t2f.nii.gz,../../DataSet/ASNR-MICCAI-BraTS2023-GLI-Challenge-TrainingData/BraTS-GLI-00108-000/BraTS-GLI-00108-000-t1n.nii.gz,../../DataSet/ASNR-MICCAI-BraTS2023-GLI-Challenge-TrainingData/BraTS-GLI-00108-000/BraTS-GLI-00108-000-seg.nii.gz,159,110,54,129,188,79,153,26,86,59,74,60
00569-000,../../DataSet/ASNR-MICCAI-BraTS2023-GLI-Challenge-TrainingData/BraTS-GLI-00569-000/BraTS-GLI-00569-000-t1c.nii.gz,../../DataSet/ASNR-MICCAI-BraTS2023-GLI-Challenge-TrainingData/BraTS-GLI-00569-000/BraTS-GLI-00569-000-t2w.nii.gz,../../DataSet/ASNR-MICCAI-BraTS2023-GLI-Challenge-TrainingData/BraTS-GLI-00569-000/BraTS-GLI-00569-000-t2f.nii.gz,../../DataSet/ASNR-MICCAI-BraTS2023-GLI-Challenge-TrainingData/BraTS-GLI-00569-000/BraTS-GLI-00569-000-t1n.nii.gz,../../DataSet/ASNR-MICCAI-BraTS2023-GLI-Challenge-TrainingData/BraTS-GLI-00569-000/BraTS-GLI-00569-000-seg.nii.gz,86,147,88,57,124,105,188,55,125,67,83,70
01329-000,../../DataSet/ASNR-MICCAI-BraTS2023-GLI-Challenge-TrainingData/BraTS-GLI-01329-000/BraTS-GLI-01329-000-t1c.nii.gz,../../DataSet/ASNR-MICCAI-BraTS2023-GLI-Challenge-TrainingData/BraTS-GLI-01329-000/BraTS-GLI-01329-000-t2w.nii.gz,../../DataSet/ASNR-MICCAI-BraTS2023-GLI-Challenge-TrainingData/BraTS-GLI-01329-000/BraTS-GLI-01329-000-t2f.nii.gz,../../DataSet/ASNR-MICCAI-BraTS2023-GLI-Challenge-TrainingData/BraTS-GLI-01329-000/BraTS-GLI-01329-000-t1n.nii.gz,../../DataSet/ASNR-MICCAI-BraTS2023-GLI-Challenge-TrainingData/BraTS-GLI-01329-000/BraTS-GLI-01329-000-seg.nii.gz,141,174,81,123,164,143,204,54,109,41,61,55
01507-000,../../DataSet/ASNR-MICCAI-BraTS2023-GLI-Challenge-TrainingData/BraTS-GLI-01507-000/BraTS-GLI-01507-000-t1c.nii.gz,../../DataSet/ASNR-MICCAI-BraTS2023-GLI-Challenge-TrainingData/BraTS-GLI-01507-000/BraTS-GLI-01507-000-t2w.nii.gz,../../DataSet/ASNR-MICCAI-BraTS2023-GLI-Challenge-TrainingData/BraTS-GLI-01507-000/BraTS-GLI-01507-000-t2f.nii.gz,../../DataSet/ASNR-MICCAI-BraTS2023-GLI-Challenge-TrainingData/BraTS-GLI-01507-000/BraTS-GLI-01507-000-t1n.nii.gz,../../DataSet/ASNR-MICCAI-BraTS2023-GLI-Challenge-TrainingData/BraTS-GLI-01507-000/BraTS-GLI-01507-000-seg.nii.gz,73,122,63,51,107,84,165,29,101,56,81,72
00347-000,../../DataSet/ASNR-MICCAI-BraTS2023-GLI-Challenge-TrainingData/BraTS-GLI-00347-000/BraTS-GLI-00347-000-t1c.nii.gz,../../DataSet/ASNR-MICCAI-BraTS2023-GLI-Challenge-TrainingData/BraTS-GLI-00347-000/BraTS-GLI-00347-000-t2w.nii.gz,../../DataSet/ASNR-MICCAI-BraTS2023-GLI-Challenge-TrainingData/BraTS-GLI-00347-000/BraTS-GLI-00347-000-t2f.nii.gz,../../DataSet/ASNR-MICCAI-BraTS2023-GLI-Challenge-TrainingData/BraTS-GLI-00347-000/BraTS-GLI-00347-000-t1n.nii.gz,../../DataSet/ASNR-MICCAI-BraTS2023-GLI-Challenge-TrainingData/BraTS-GLI-00347-000/BraTS-GLI-00347-000-seg.nii.gz,84,124,64,59,115,79,166,30,100,56,87,70
00081-000,../../DataSet/ASNR-MICCAI-BraTS2023-GLI-Challenge-TrainingData/BraTS-GLI-00081-000/BraTS-GLI-00081-000-t1c.nii.gz,../../DataSet/ASNR-MICCAI-BraTS2023-GLI-Challenge-TrainingData/BraTS-GLI-00081-000/BraTS-GLI-00081-000-t2w.nii.gz,../../DataSet/ASNR-MICCAI-BraTS2023-GLI-Challenge-TrainingData/BraTS-GLI-00081-000/BraTS-GLI-00081-000-t2f.nii.gz,../../DataSet/ASNR-MICCAI-BraTS2023-GLI-Challenge-TrainingData/BraTS-GLI-00081-000/BraTS-GLI-00081-000-t1n.nii.gz,../../DataSet/ASNR-MICCAI-BraTS2023-GLI-Challenge-TrainingData/BraTS-GLI-00081-000/BraTS-GLI-00081-000-seg.nii.gz,147,175,72,117,175,135,208,48,100,58,73,52
01166-000,../../DataSet/ASNR-MICCAI-BraTS2023-GLI-Challenge-TrainingData/BraTS-GLI-01166-000/BraTS-GLI-01166-000-t1c.nii.gz,../../DataSet/ASNR-MICCAI-BraTS2023-GLI-Challenge-TrainingData/BraTS-GLI-01166-000/BraTS-GLI-01166-000-t2w.nii.gz,../../DataSet/ASNR-MICCAI-BraTS2023-GLI-Challenge-TrainingData/BraTS-GLI-01166-000/BraTS-GLI-01166-000-t2f.nii.gz,../../DataSet/ASNR-MICCAI-BraTS2023-GLI-Challenge-TrainingData/BraTS-GLI-01166-000/BraTS-GLI-01166-000-t1n.nii.gz,../../DataSet/ASNR-MICCAI-BraTS2023-GLI-Challenge-TrainingData/BraTS-GLI-01166-000/BraTS-GLI-01166-000-seg.nii.gz,106,150,76,72,145,131,185,58,96,73,54,38
01610-000,../../DataSet/ASNR-MICCAI-BraTS2023-GLI-Challenge-TrainingData/BraTS-GLI-01610-000/BraTS-GLI-01610-000-t1c.nii.gz,../../DataSet/ASNR-MICCAI-BraTS2023-GLI-Challenge-TrainingData/BraTS-GLI-01610-000/BraTS-GLI-01610-000-t2w.nii.gz,../../DataSet/ASNR-MICCAI-BraTS2023-GLI-Challenge-TrainingData/BraTS-GLI-01610-000/BraTS-GLI-01610-000-t2f.nii.gz,../../DataSet/ASNR-MICCAI-BraTS2023-GLI-Challenge-TrainingData/BraTS-GLI-01610-000/BraTS-GLI-01610-000-t1n.nii.gz,../../DataSet/ASNR-MICCAI-BraTS2023-GLI-Challenge-TrainingData/BraTS-GLI-01610-000/BraTS-GLI-01610-000-seg.nii.gz,110,138,66,93,125,122,159,48,91,32,37,43
00675-001,../../DataSet/ASNR-MICCAI-BraTS2023-GLI-Challenge-TrainingData/BraTS-GLI-00675-001/BraTS-GLI-00675-001-t1c.nii.gz,../../DataSet/ASNR-MICCAI-BraTS2023-GLI-Challenge-TrainingData/BraTS-GLI-00675-001/BraTS-GLI-00675-001-t2w.nii.gz,../../DataSet/ASNR-MICCAI-BraTS2023-GLI-Challenge-TrainingData/BraTS-GLI-00675-001/BraTS-GLI-00675-001-t2f.nii.gz,../../DataSet/ASNR-MICCAI-BraTS2023-GLI-Challenge-TrainingData/BraTS-GLI-00675-001/BraTS-GLI-00675-001-t1n.nii.gz,../../DataSet/ASNR-MICCAI-BraTS2023-GLI-Challenge-TrainingData/BraTS-GLI-00675-001/BraTS-GLI-00675-001-seg.nii.gz,169,107,55,158,181,85,132,42,70,23,47,28
00431-000,../../DataSet/ASNR-MICCAI-BraTS2023-GLI-Challenge-TrainingData/BraTS-GLI-00431-000/BraTS-GLI-00431-000-t1c.nii.gz,../../DataSet/ASNR-MICCAI-BraTS2023-GLI-Challenge-TrainingData/BraTS-GLI-00431-000/BraTS-GLI-00431-000-t2w.nii.gz,../../DataSet/ASNR-MICCAI-BraTS2023-GLI-Challenge-TrainingData/BraTS-GLI-00431-000/BraTS-GLI-00431-000-t2f.nii.gz,../../DataSet/ASNR-MICCAI-BraTS2023-GLI-Challenge-TrainingData/BraTS-GLI-00431-000/BraTS-GLI-00431-000-t1n.nii.gz,../../DataSet/ASNR-MICCAI-BraTS2023-GLI-Challenge-TrainingData/BraTS-GLI-00431-000/BraTS-GLI-00431-000-seg.nii.gz,157,95,84,135,178,77,123,66,110,43,46,44
01271-000,../../DataSet/ASNR-MICCAI-BraTS2023-GLI-Challenge-TrainingData/BraTS-GLI-01271-000/BraTS-GLI-01271-000-t1c.nii.gz,../../DataSet/ASNR-MICCAI-BraTS2023-GLI-Challenge-TrainingData/BraTS-GLI-01271-000/BraTS-GLI-01271-000-t2w.nii.gz,../../DataSet/ASNR-MICCAI-BraTS2023-GLI-Challenge-TrainingData/BraTS-GLI-01271-000/BraTS-GLI-01271-000-t2f.nii.gz,../../DataSet/ASNR-MICCAI-BraTS2023-GLI-Challenge-TrainingData/BraTS-GLI-01271-000/BraTS-GLI-01271-000-t1n.nii.gz,../../DataSet/ASNR-MICCAI-BraTS2023-GLI-Challenge-TrainingData/BraTS-GLI-01271-000/BraTS-GLI-01271-000-seg.nii.gz,100,164,96,83,120,129,194,63,126,37,65,63
00218-000,../../DataSet/ASNR-MICCAI-BraTS2023-GLI-Challenge-TrainingData/BraTS-GLI-00218-000/BraTS-GLI-00218-000-t1c.nii.gz,../../DataSet/ASNR-MICCAI-BraTS2023-GLI-Challenge-TrainingData/BraTS-GLI-00218-000/BraTS-GLI-00218-000-t2w.nii.gz,../../DataSet/ASNR-MICCAI-BraTS2023-GLI-Challenge-TrainingData/BraTS-GLI-00218-000/BraTS-GLI-00218-000-t2f.nii.gz,../../DataSet/ASNR-MICCAI-BraTS2023-GLI-Challenge-TrainingData/BraTS-GLI-00218-000/BraTS-GLI-00218-000-t1n.nii.gz,../../DataSet/ASNR-MICCAI-BraTS2023-GLI-Challenge-TrainingData/BraTS-GLI-00218-000/BraTS-GLI-00218-000-seg.nii.gz,141,128,124,126,156,109,150,107,140,30,41,33
01458-000,../../DataSet/ASNR-MICCAI-BraTS2023-GLI-Challenge-TrainingData/BraTS-GLI-01458-000/BraTS-GLI-01458-000-t1c.nii.gz,../../DataSet/ASNR-MICCAI-BraTS2023-GLI-Challenge-TrainingData/BraTS-GLI-01458-000/BraTS-GLI-01458-000-t2w.nii.gz,../../DataSet/ASNR-MICCAI-BraTS2023-GLI-Challenge-TrainingData/BraTS-GLI-01458-000/BraTS-GLI-01458-000-t2f.nii.gz,../../DataSet/ASNR-MICCAI-BraTS2023-GLI-Challenge-TrainingData/BraTS-GLI-01458-000/BraTS-GLI-01458-000-t1n.nii.gz,../../DataSet/ASNR-MICCAI-BraTS2023-GLI-Challenge-TrainingData/BraTS-GLI-01458-000/BraTS-GLI-01458-000-seg.nii.gz,141,174,83,94,166,130,210,59,108,72,80,49
01039-000,../../DataSet/ASNR-MICCAI-BraTS2023-GLI-Challenge-TrainingData/BraTS-GLI-01039-000/BraTS-GLI-01039-000-t1c.nii.gz,../../DataSet/ASNR-MICCAI-BraTS2023-GLI-Challenge-TrainingData/BraTS-GLI-01039-000/BraTS-GLI-01039-000-t2w.nii.gz,../../DataSet/ASNR-MICCAI-BraTS2023-GLI-Challenge-TrainingData/BraTS-GLI-01039-000/BraTS-GLI-01039-000-t2f.nii.gz,../../DataSet/ASNR-MICCAI-BraTS2023-GLI-Challenge-TrainingData/BraTS-GLI-01039-000/BraTS-GLI-01039-000-t1n.nii.gz,../../DataSet/ASNR-MICCAI-BraTS2023-GLI-Challenge-TrainingData/BraTS-GLI-01039-000/BraTS-GLI-01039-000-seg.nii.gz,102,107,115,86,120,89,130,99,130,34,41,31
00340-000,../../DataSet/ASNR-MICCAI-BraTS2023-GLI-Challenge-TrainingData/BraTS-GLI-00340-000/BraTS-GLI-00340-000-t1c.nii.gz,../../DataSet/ASNR-MICCAI-BraTS2023-GLI-Challenge-TrainingData/BraTS-GLI-00340-000/BraTS-GLI-00340-000-t2w.nii.gz,../../DataSet/ASNR-MICCAI-BraTS2023-GLI-Challenge-TrainingData/BraTS-GLI-00340-000/BraTS-GLI-00340-000-t2f.nii.gz,../../DataSet/ASNR-MICCAI-BraTS2023-GLI-Challenge-TrainingData/BraTS-GLI-00340-000/BraTS-GLI-00340-000-t1n.nii.gz,../../DataSet/ASNR-MICCAI-BraTS2023-GLI-Challenge-TrainingData/BraTS-GLI-00340-000/BraTS-GLI-00340-000-seg.nii.gz,148,132,96,117,173,97,174,55,123,56,77,68
01500-000,../../DataSet/ASNR-MICCAI-BraTS2023-GLI-Challenge-TrainingData/BraTS-GLI-01500-000/BraTS-GLI-01500-000-t1c.nii.gz,../../DataSet/ASNR-MICCAI-BraTS2023-GLI-Challenge-TrainingData/BraTS-GLI-01500-000/BraTS-GLI-01500-000-t2w.nii.gz,../../DataSet/ASNR-MICCAI-BraTS2023-GLI-Challenge-TrainingData/BraTS-GLI-01500-000/BraTS-GLI-01500-000-t2f.nii.gz,../../DataSet/ASNR-MICCAI-BraTS2023-GLI-Challenge-TrainingData/BraTS-GLI-01500-000/BraTS-GLI-01500-000-t1n.nii.gz,../../DataSet/ASNR-MICCAI-BraTS2023-GLI-Challenge-TrainingData/BraTS-GLI-01500-000/BraTS-GLI-01500-000-seg.nii.gz,102,104,116,83,121,84,129,97,135,38,45,38
01161-000,../../DataSet/ASNR-MICCAI-BraTS2023-GLI-Challenge-TrainingData/BraTS-GLI-01161-000/BraTS-GLI-01161-000-t1c.nii.gz,../../DataSet/ASNR-MICCAI-BraTS2023-GLI-Challenge-TrainingData/BraTS-GLI-01161-000/BraTS-GLI-01161-000-t2w.nii.gz,../../DataSet/ASNR-MICCAI-BraTS2023-GLI-Challenge-TrainingData/BraTS-GLI-01161-000/BraTS-GLI-01161-000-t2f.nii.gz,../../DataSet/ASNR-MICCAI-BraTS2023-GLI-Challenge-TrainingData/BraTS-GLI-01161-000/BraTS-GLI-01161-000-t1n.nii.gz,../../DataSet/ASNR-MICCAI-BraTS2023-GLI-Challenge-TrainingData/BraTS-GLI-01161-000/BraTS-GLI-01161-000-seg.nii.gz,88,126,67,62,124,76,172,35,98,62,96,63
01276-000,../../DataSet/ASNR-MICCAI-BraTS2023-GLI-Challenge-TrainingData/BraTS-GLI-01276-000/BraTS-GLI-01276-000-t1c.nii.gz,../../DataSet/ASNR-MICCAI-BraTS2023-GLI-Challenge-TrainingData/BraTS-GLI-01276-000/BraTS-GLI-01276-000-t2w.nii.gz,../../DataSet/ASNR-MICCAI-BraTS2023-GLI-Challenge-TrainingData/BraTS-GLI-01276-000/BraTS-GLI-01276-000-t2f.nii.gz,../../DataSet/ASNR-MICCAI-BraTS2023-GLI-Challenge-TrainingData/BraTS-GLI-01276-000/BraTS-GLI-01276-000-t1n.nii.gz,../../DataSet/ASNR-MICCAI-BraTS2023-GLI-Challenge-TrainingData/BraTS-GLI-01276-000/BraTS-GLI-01276-000-seg.nii.gz,117,142,69,92,138,92,163,50,94,46,71,44
00391-000,../../DataSet/ASNR-MICCAI-BraTS2023-GLI-Challenge-TrainingData/BraTS-GLI-00391-000/BraTS-GLI-00391-000-t1c.nii.gz,../../DataSet/ASNR-MICCAI-BraTS2023-GLI-Challenge-TrainingData/BraTS-GLI-00391-000/BraTS-GLI-00391-000-t2w.nii.gz,../../DataSet/ASNR-MICCAI-BraTS2023-GLI-Challenge-TrainingData/BraTS-GLI-00391-000/BraTS-GLI-00391-000-t2f.nii.gz,../../DataSet/ASNR-MICCAI-BraTS2023-GLI-Challenge-TrainingData/BraTS-GLI-00391-000/BraTS-GLI-00391-000-t1n.nii.gz,../../DataSet/ASNR-MICCAI-BraTS2023-GLI-Challenge-TrainingData/BraTS-GLI-00391-000/BraTS-GLI-00391-000-seg.nii.gz,78,156,66,52,113,113,195,37,108,61,82,71
00436-000,../../DataSet/ASNR-MICCAI-BraTS2023-GLI-Challenge-TrainingData/BraTS-GLI-00436-000/BraTS-GLI-00436-000-t1c.nii.gz,../../DataSet/ASNR-MICCAI-BraTS2023-GLI-Challenge-TrainingData/BraTS-GLI-00436-000/BraTS-GLI-00436-000-t2w.nii.gz,../../DataSet/ASNR-MICCAI-BraTS2023-GLI-Challenge-TrainingData/BraTS-GLI-00436-000/BraTS-GLI-00436-000-t2f.nii.gz,../../DataSet/ASNR-MICCAI-BraTS2023-GLI-Challenge-TrainingData/BraTS-GLI-00436-000/BraTS-GLI-00436-000-t1n.nii.gz,../../DataSet/ASNR-MICCAI-BraTS2023-GLI-Challenge-TrainingData/BraTS-GLI-00436-000/BraTS-GLI-00436-000-seg.nii.gz,92,125,77,69,117,83,165,48,111,48,82,63
00756-001,../../DataSet/ASNR-MICCAI-BraTS2023-GLI-Challenge-TrainingData/BraTS-GLI-00756-001/BraTS-GLI-00756-001-t1c.nii.gz,../../DataSet/ASNR-MICCAI-BraTS2023-GLI-Challenge-TrainingData/BraTS-GLI-00756-001/BraTS-GLI-00756-001-t2w.nii.gz,../../DataSet/ASNR-MICCAI-BraTS2023-GLI-Challenge-TrainingData/BraTS-GLI-00756-001/BraTS-GLI-00756-001-t2f.nii.gz,../../DataSet/ASNR-MICCAI-BraTS2023-GLI-Challenge-TrainingData/BraTS-GLI-00756-001/BraTS-GLI-00756-001-t1n.nii.gz,../../DataSet/ASNR-MICCAI-BraTS2023-GLI-Challenge-TrainingData/BraTS-GLI-00756-001/BraTS-GLI-00756-001-seg.nii.gz,102,108,102,68,131,60,152,72,137,63,92,65
01094-000,../../DataSet/ASNR-MICCAI-BraTS2023-GLI-Challenge-TrainingData/BraTS-GLI-01094-000/BraTS-GLI-01094-000-t1c.nii.gz,../../DataSet/ASNR-MICCAI-BraTS2023-GLI-Challenge-TrainingData/BraTS-GLI-01094-000/BraTS-GLI-01094-000-t2w.nii.gz,../../DataSet/ASNR-MICCAI-BraTS2023-GLI-Challenge-TrainingData/BraTS-GLI-01094-000/BraTS-GLI-01094-000-t2f.nii.gz,../../DataSet/ASNR-MICCAI-BraTS2023-GLI-Challenge-TrainingData/BraTS-GLI-01094-000/BraTS-GLI-01094-000-t1n.nii.gz,../../DataSet/ASNR-MICCAI-BraTS2023-GLI-Challenge-TrainingData/BraTS-GLI-01094-000/BraTS-GLI-01094-000-seg.nii.gz,143,170,101,119,175,133,208,63,139,56,75,76
01352-000,../../DataSet/ASNR-MICCAI-BraTS2023-GLI-Challenge-TrainingData/BraTS-GLI-01352-000/BraTS-GLI-01352-000-t1c.nii.gz,../../DataSet/ASNR-MICCAI-BraTS2023-GLI-Challenge-TrainingData/BraTS-GLI-01352-000/BraTS-GLI-01352-000-t2w.nii.gz,../../DataSet/ASNR-MICCAI-BraTS2023-GLI-Challenge-TrainingData/BraTS-GLI-01352-000/BraTS-GLI-01352-000-t2f.nii.gz,../../DataSet/ASNR-MICCAI-BraTS2023-GLI-Challenge-TrainingData/BraTS-GLI-01352-000/BraTS-GLI-01352-000-t1n.nii.gz,../../DataSet/ASNR-MICCAI-BraTS2023-GLI-Challenge-TrainingData/BraTS-GLI-01352-000/BraTS-GLI-01352-000-seg.nii.gz,87,167,61,65,144,120,201,38,93,79,81,55
01383-000,../../DataSet/ASNR-MICCAI-BraTS2023-GLI-Challenge-TrainingData/BraTS-GLI-01383-000/BraTS-GLI-01383-000-t1c.nii.gz,../../DataSet/ASNR-MICCAI-BraTS2023-GLI-Challenge-TrainingData/BraTS-GLI-01383-000/BraTS-GLI-01383-000-t2w.nii.gz,../../DataSet/ASNR-MICCAI-BraTS2023-GLI-Challenge-TrainingData/BraTS-GLI-01383-000/BraTS-GLI-01383-000-t2f.nii.gz,../../DataSet/ASNR-MICCAI-BraTS2023-GLI-Challenge-TrainingData/BraTS-GLI-01383-000/BraTS-GLI-01383-000-t1n.nii.gz,../../DataSet/ASNR-MICCAI-BraTS2023-GLI-Challenge-TrainingData/BraTS-GLI-01383-000/BraTS-GLI-01383-000-seg.nii.gz,151,120,63,124,177,82,167,29,103,53,85,74
01424-000,../../DataSet/ASNR-MICCAI-BraTS2023-GLI-Challenge-TrainingData/BraTS-GLI-01424-000/BraTS-GLI-01424-000-t1c.nii.gz,../../DataSet/ASNR-MICCAI-BraTS2023-GLI-Challenge-TrainingData/BraTS-GLI-01424-000/BraTS-GLI-01424-000-t2w.nii.gz,../../DataSet/ASNR-MICCAI-BraTS2023-GLI-Challenge-TrainingData/BraTS-GLI-01424-000/BraTS-GLI-01424-000-t2f.nii.gz,../../DataSet/ASNR-MICCAI-BraTS2023-GLI-Challenge-TrainingData/BraTS-GLI-01424-000/BraTS-GLI-01424-000-t1n.nii.gz,../../DataSet/ASNR-MICCAI-BraTS2023-GLI-Challenge-TrainingData/BraTS-GLI-01424-000/BraTS-GLI-01424-000-seg.nii.gz,143,90,82,109,179,52,131,47,118,70,79,71
01045-000,../../DataSet/ASNR-MICCAI-BraTS2023-GLI-Challenge-TrainingData/BraTS-GLI-01045-000/BraTS-GLI-01045-000-t1c.nii.gz,../../DataSet/ASNR-MICCAI-BraTS2023-GLI-Challenge-TrainingData/BraTS-GLI-01045-000/BraTS-GLI-01045-000-t2w.nii.gz,../../DataSet/ASNR-MICCAI-BraTS2023-GLI-Challenge-TrainingData/BraTS-GLI-01045-000/BraTS-GLI-01045-000-t2f.nii.gz,../../DataSet/ASNR-MICCAI-BraTS2023-GLI-Challenge-TrainingData/BraTS-GLI-01045-000/BraTS-GLI-01045-000-t1n.nii.gz,../../DataSet/ASNR-MICCAI-BraTS2023-GLI-Challenge-TrainingData/BraTS-GLI-01045-000/BraTS-GLI-01045-000-seg.nii.gz,137,82,77,84,179,36,127,39,118,95,91,79
00020-001,../../DataSet/ASNR-MICCAI-BraTS2023-GLI-Challenge-TrainingData/BraTS-GLI-00020-001/BraTS-GLI-00020-001-t1c.nii.gz,../../DataSet/ASNR-MICCAI-BraTS2023-GLI-Challenge-TrainingData/BraTS-GLI-00020-001/BraTS-GLI-00020-001-t2w.nii.gz,../../DataSet/ASNR-MICCAI-BraTS2023-GLI-Challenge-TrainingData/BraTS-GLI-00020-001/BraTS-GLI-00020-001-t2f.nii.gz,../../DataSet/ASNR-MICCAI-BraTS2023-GLI-Challenge-TrainingData/BraTS-GLI-00020-001/BraTS-GLI-00020-001-t1n.nii.gz,../../DataSet/ASNR-MICCAI-BraTS2023-GLI-Challenge-TrainingData/BraTS-GLI-00020-001/BraTS-GLI-00020-001-seg.nii.gz,92,179,60,70,136,139,208,38,89,66,69,51
00838-000,../../DataSet/ASNR-MICCAI-BraTS2023-GLI-Challenge-TrainingData/BraTS-GLI-00838-000/BraTS-GLI-00838-000-t1c.nii.gz,../../DataSet/ASNR-MICCAI-BraTS2023-GLI-Challenge-TrainingData/BraTS-GLI-00838-000/BraTS-GLI-00838-000-t2w.nii.gz,../../DataSet/ASNR-MICCAI-BraTS2023-GLI-Challenge-TrainingData/BraTS-GLI-00838-000/BraTS-GLI-00838-000-t2f.nii.gz,../../DataSet/ASNR-MICCAI-BraTS2023-GLI-Challenge-TrainingData/BraTS-GLI-00838-000/BraTS-GLI-00838-000-t1n.nii.gz,../../DataSet/ASNR-MICCAI-BraTS2023-GLI-Challenge-TrainingData/BraTS-GLI-00838-000/BraTS-GLI-00838-000-seg.nii.gz,99,91,83,67,131,48,138,52,116,64,90,64
00046-000,../../DataSet/ASNR-MICCAI-BraTS2023-GLI-Challenge-TrainingData/BraTS-GLI-00046-000/BraTS-GLI-00046-000-t1c.nii.gz,../../DataSet/ASNR-MICCAI-BraTS2023-GLI-Challenge-TrainingData/BraTS-GLI-00046-000/BraTS-GLI-00046-000-t2w.nii.gz,../../DataSet/ASNR-MICCAI-BraTS2023-GLI-Challenge-TrainingData/BraTS-GLI-00046-000/BraTS-GLI-00046-000-t2f.nii.gz,../../DataSet/ASNR-MICCAI-BraTS2023-GLI-Challenge-TrainingData/BraTS-GLI-00046-000/BraTS-GLI-00046-000-t1n.nii.gz,../../DataSet/ASNR-MICCAI-BraTS2023-GLI-Challenge-TrainingData/BraTS-GLI-00046-000/BraTS-GLI-00046-000-seg.nii.gz,92,147,93,66,114,121,173,75,118,48,52,43
01267-000,../../DataSet/ASNR-MICCAI-BraTS2023-GLI-Challenge-TrainingData/BraTS-GLI-01267-000/BraTS-GLI-01267-000-t1c.nii.gz,../../DataSet/ASNR-MICCAI-BraTS2023-GLI-Challenge-TrainingData/BraTS-GLI-01267-000/BraTS-GLI-01267-000-t2w.nii.gz,../../DataSet/ASNR-MICCAI-BraTS2023-GLI-Challenge-TrainingData/BraTS-GLI-01267-000/BraTS-GLI-01267-000-t2f.nii.gz,../../DataSet/ASNR-MICCAI-BraTS2023-GLI-Challenge-TrainingData/BraTS-GLI-01267-000/BraTS-GLI-01267-000-t1n.nii.gz,../../DataSet/ASNR-MICCAI-BraTS2023-GLI-Challenge-TrainingData/BraTS-GLI-01267-000/BraTS-GLI-01267-000-seg.nii.gz,149,162,84,117,183,118,207,42,128,66,89,86
00380-000,../../DataSet/ASNR-MICCAI-BraTS2023-GLI-Challenge-TrainingData/BraTS-GLI-00380-000/BraTS-GLI-00380-000-t1c.nii.gz,../../DataSet/ASNR-MICCAI-BraTS2023-GLI-Challenge-TrainingData/BraTS-GLI-00380-000/BraTS-GLI-00380-000-t2w.nii.gz,../../DataSet/ASNR-MICCAI-BraTS2023-GLI-Challenge-TrainingData/BraTS-GLI-00380-000/BraTS-GLI-00380-000-t2f.nii.gz,../../DataSet/ASNR-MICCAI-BraTS2023-GLI-Challenge-TrainingData/BraTS-GLI-00380-000/BraTS-GLI-00380-000-t1n.nii.gz,../../DataSet/ASNR-MICCAI-BraTS2023-GLI-Challenge-TrainingData/BraTS-GLI-00380-000/BraTS-GLI-00380-000-seg.nii.gz,175,137,59,160,186,118,154,42,73,26,36,31
00351-000,../../DataSet/ASNR-MICCAI-BraTS2023-GLI-Challenge-TrainingData/BraTS-GLI-00351-000/BraTS-GLI-00351-000-t1c.nii.gz,../../DataSet/ASNR-MICCAI-BraTS2023-GLI-Challenge-TrainingData/BraTS-GLI-00351-000/BraTS-GLI-00351-000-t2w.nii.gz,../../DataSet/ASNR-MICCAI-BraTS2023-GLI-Challenge-TrainingData/BraTS-GLI-00351-000/BraTS-GLI-00351-000-t2f.nii.gz,../../DataSet/ASNR-MICCAI-BraTS2023-GLI-Challenge-TrainingData/BraTS-GLI-00351-000/BraTS-GLI-00351-000-t1n.nii.gz,../../DataSet/ASNR-MICCAI-BraTS2023-GLI-Challenge-TrainingData/BraTS-GLI-00351-000/BraTS-GLI-00351-000-seg.nii.gz,86,114,57,59,120,79,174,22,93,61,95,71
01170-000,../../DataSet/ASNR-MICCAI-BraTS2023-GLI-Challenge-TrainingData/BraTS-GLI-01170-000/BraTS-GLI-01170-000-t1c.nii.gz,../../DataSet/ASNR-MICCAI-BraTS2023-GLI-Challenge-TrainingData/BraTS-GLI-01170-000/BraTS-GLI-01170-000-t2w.nii.gz,../../DataSet/ASNR-MICCAI-BraTS2023-GLI-Challenge-TrainingData/BraTS-GLI-01170-000/BraTS-GLI-01170-000-t2f.nii.gz,../../DataSet/ASNR-MICCAI-BraTS2023-GLI-Challenge-TrainingData/BraTS-GLI-01170-000/BraTS-GLI-01170-000-t1n.nii.gz,../../DataSet/ASNR-MICCAI-BraTS2023-GLI-Challenge-TrainingData/BraTS-GLI-01170-000/BraTS-GLI-01170-000-seg.nii.gz,118,156,80,80,161,108,195,44,117,81,87,73
00097-000,../../DataSet/ASNR-MICCAI-BraTS2023-GLI-Challenge-TrainingData/BraTS-GLI-00097-000/BraTS-GLI-00097-000-t1c.nii.gz,../../DataSet/ASNR-MICCAI-BraTS2023-GLI-Challenge-TrainingData/BraTS-GLI-00097-000/BraTS-GLI-00097-000-t2w.nii.gz,../../DataSet/ASNR-MICCAI-BraTS2023-GLI-Challenge-TrainingData/BraTS-GLI-00097-000/BraTS-GLI-00097-000-t2f.nii.gz,../../DataSet/ASNR-MICCAI-BraTS2023-GLI-Challenge-TrainingData/BraTS-GLI-00097-000/BraTS-GLI-00097-000-t1n.nii.gz,../../DataSet/ASNR-MICCAI-BraTS2023-GLI-Challenge-TrainingData/BraTS-GLI-00097-000/BraTS-GLI-00097-000-seg.nii.gz,162,154,93,140,183,134,183,70,115,43,49,45
00730-000,../../DataSet/ASNR-MICCAI-BraTS2023-GLI-Challenge-TrainingData/BraTS-GLI-00730-000/BraTS-GLI-00730-000-t1c.nii.gz,../../DataSet/ASNR-MICCAI-BraTS2023-GLI-Challenge-TrainingData/BraTS-GLI-00730-000/BraTS-GLI-00730-000-t2w.nii.gz,../../DataSet/ASNR-MICCAI-BraTS2023-GLI-Challenge-TrainingData/BraTS-GLI-00730-000/BraTS-GLI-00730-000-t2f.nii.gz,../../DataSet/ASNR-MICCAI-BraTS2023-GLI-Challenge-TrainingData/BraTS-GLI-00730-000/BraTS-GLI-00730-000-t1n.nii.gz,../../DataSet/ASNR-MICCAI-BraTS2023-GLI-Challenge-TrainingData/BraTS-GLI-00730-000/BraTS-GLI-00730-000-seg.nii.gz,88,137,106,57,114,106,171,80,136,57,65,56
00209-000,../../DataSet/ASNR-MICCAI-BraTS2023-GLI-Challenge-TrainingData/BraTS-GLI-00209-000/BraTS-GLI-00209-000-t1c.nii.gz,../../DataSet/ASNR-MICCAI-BraTS2023-GLI-Challenge-TrainingData/BraTS-GLI-00209-000/BraTS-GLI-00209-000-t2w.nii.gz,../../DataSet/ASNR-MICCAI-BraTS2023-GLI-Challenge-TrainingData/BraTS-GLI-00209-000/BraTS-GLI-00209-000-t2f.nii.gz,../../DataSet/ASNR-MICCAI-BraTS2023-GLI-Challenge-TrainingData/BraTS-GLI-00209-000/BraTS-GLI-00209-000-t1n.nii.gz,../../DataSet/ASNR-MICCAI-BraTS2023-GLI-Challenge-TrainingData/BraTS-GLI-00209-000/BraTS-GLI-00209-000-seg.nii.gz,71,139,59,46,112,112,171,39,85,66,59,46
01449-000,../../DataSet/ASNR-MICCAI-BraTS2023-GLI-Challenge-TrainingData/BraTS-GLI-01449-000/BraTS-GLI-01449-000-t1c.nii.gz,../../DataSet/ASNR-MICCAI-BraTS2023-GLI-Challenge-TrainingData/BraTS-GLI-01449-000/BraTS-GLI-01449-000-t2w.nii.gz,../../DataSet/ASNR-MICCAI-BraTS2023-GLI-Challenge-TrainingData/BraTS-GLI-01449-000/BraTS-GLI-01449-000-t2f.nii.gz,../../DataSet/ASNR-MICCAI-BraTS2023-GLI-Challenge-TrainingData/BraTS-GLI-01449-000/BraTS-GLI-01449-000-t1n.nii.gz,../../DataSet/ASNR-MICCAI-BraTS2023-GLI-Challenge-TrainingData/BraTS-GLI-01449-000/BraTS-GLI-01449-000-seg.nii.gz,149,175,65,121,180,137,207,33,104,59,70,71
01028-000,../../DataSet/ASNR-MICCAI-BraTS2023-GLI-Challenge-TrainingData/BraTS-GLI-01028-000/BraTS-GLI-01028-000-t1c.nii.gz,../../DataSet/ASNR-MICCAI-BraTS2023-GLI-Challenge-TrainingData/BraTS-GLI-01028-000/BraTS-GLI-01028-000-t2w.nii.gz,../../DataSet/ASNR-MICCAI-BraTS2023-GLI-Challenge-TrainingData/BraTS-GLI-01028-000/BraTS-GLI-01028-000-t2f.nii.gz,../../DataSet/ASNR-MICCAI-BraTS2023-GLI-Challenge-TrainingData/BraTS-GLI-01028-000/BraTS-GLI-01028-000-t1n.nii.gz,../../DataSet/ASNR-MICCAI-BraTS2023-GLI-Challenge-TrainingData/BraTS-GLI-01028-000/BraTS-GLI-01028-000-seg.nii.gz,158,147,65,131,186,101,194,37,94,55,93,57
00275-000,../../DataSet/ASNR-MICCAI-BraTS2023-GLI-Challenge-TrainingData/BraTS-GLI-00275-000/BraTS-GLI-00275-000-t1c.nii.gz,../../DataSet/ASNR-MICCAI-BraTS2023-GLI-Challenge-TrainingData/BraTS-GLI-00275-000/BraTS-GLI-00275-000-t2w.nii.gz,../../DataSet/ASNR-MICCAI-BraTS2023-GLI-Challenge-TrainingData/BraTS-GLI-00275-000/BraTS-GLI-00275-000-t2f.nii.gz,../../DataSet/ASNR-MICCAI-BraTS2023-GLI-Challenge-TrainingData/BraTS-GLI-00275-000/BraTS-GLI-00275-000-t1n.nii.gz,../../DataSet/ASNR-MICCAI-BraTS2023-GLI-Challenge-TrainingData/BraTS-GLI-00275-000/BraTS-GLI-00275-000-seg.nii.gz,153,171,58,122,183,140,206,33,90,61,66,57
01435-000,../../DataSet/ASNR-MICCAI-BraTS2023-GLI-Challenge-TrainingData/BraTS-GLI-01435-000/BraTS-GLI-01435-000-t1c.nii.gz,../../DataSet/ASNR-MICCAI-BraTS2023-GLI-Challenge-TrainingData/BraTS-GLI-01435-000/BraTS-GLI-01435-000-t2w.nii.gz,../../DataSet/ASNR-MICCAI-BraTS2023-GLI-Challenge-TrainingData/BraTS-GLI-01435-000/BraTS-GLI-01435-000-t2f.nii.gz,../../DataSet/ASNR-MICCAI-BraTS2023-GLI-Challenge-TrainingData/BraTS-GLI-01435-000/BraTS-GLI-01435-000-t1n.nii.gz,../../DataSet/ASNR-MICCAI-BraTS2023-GLI-Challenge-TrainingData/BraTS-GLI-01435-000/BraTS-GLI-01435-000-seg.nii.gz,83,74,76,66,106,54,94,62,94,40,40,32
01392-000,../../DataSet/ASNR-MICCAI-BraTS2023-GLI-Challenge-TrainingData/BraTS-GLI-01392-000/BraTS-GLI-01392-000-t1c.nii.gz,../../DataSet/ASNR-MICCAI-BraTS2023-GLI-Challenge-TrainingData/BraTS-GLI-01392-000/BraTS-GLI-01392-000-t2w.nii.gz,../../DataSet/ASNR-MICCAI-BraTS2023-GLI-Challenge-TrainingData/BraTS-GLI-01392-000/BraTS-GLI-01392-000-t2f.nii.gz,../../DataSet/ASNR-MICCAI-BraTS2023-GLI-Challenge-TrainingData/BraTS-GLI-01392-000/BraTS-GLI-01392-000-t1n.nii.gz,../../DataSet/ASNR-MICCAI-BraTS2023-GLI-Challenge-TrainingData/BraTS-GLI-01392-000/BraTS-GLI-01392-000-seg.nii.gz,99,142,77,62,143,112,179,60,124,81,67,64
01054-000,../../DataSet/ASNR-MICCAI-BraTS2023-GLI-Challenge-TrainingData/BraTS-GLI-01054-000/BraTS-GLI-01054-000-t1c.nii.gz,../../DataSet/ASNR-MICCAI-BraTS2023-GLI-Challenge-TrainingData/BraTS-GLI-01054-000/BraTS-GLI-01054-000-t2w.nii.gz,../../DataSet/ASNR-MICCAI-BraTS2023-GLI-Challenge-TrainingData/BraTS-GLI-01054-000/BraTS-GLI-01054-000-t2f.nii.gz,../../DataSet/ASNR-MICCAI-BraTS2023-GLI-Challenge-TrainingData/BraTS-GLI-01054-000/BraTS-GLI-01054-000-t1n.nii.gz,../../DataSet/ASNR-MICCAI-BraTS2023-GLI-Challenge-TrainingData/BraTS-GLI-01054-000/BraTS-GLI-01054-000-seg.nii.gz,167,153,74,95,181,142,191,55,87,86,49,32
00162-000,../../DataSet/ASNR-MICCAI-BraTS2023-GLI-Challenge-TrainingData/BraTS-GLI-00162-000/BraTS-GLI-00162-000-t1c.nii.gz,../../DataSet/ASNR-MICCAI-BraTS2023-GLI-Challenge-TrainingData/BraTS-GLI-00162-000/BraTS-GLI-00162-000-t2w.nii.gz,../../DataSet/ASNR-MICCAI-BraTS2023-GLI-Challenge-TrainingData/BraTS-GLI-00162-000/BraTS-GLI-00162-000-t2f.nii.gz,../../DataSet/ASNR-MICCAI-BraTS2023-GLI-Challenge-TrainingData/BraTS-GLI-00162-000/BraTS-GLI-00162-000-t1n.nii.gz,../../DataSet/ASNR-MICCAI-BraTS2023-GLI-Challenge-TrainingData/BraTS-GLI-00162-000/BraTS-GLI-00162-000-seg.nii.gz,148,119,50,128,169,89,151,28,71,41,62,43
01343-000,../../DataSet/ASNR-MICCAI-BraTS2023-GLI-Challenge-TrainingData/BraTS-GLI-01343-000/BraTS-GLI-01343-000-t1c.nii.gz,../../DataSet/ASNR-MICCAI-BraTS2023-GLI-Challenge-TrainingData/BraTS-GLI-01343-000/BraTS-GLI-01343-000-t2w.nii.gz,../../DataSet/ASNR-MICCAI-BraTS2023-GLI-Challenge-TrainingData/BraTS-GLI-01343-000/BraTS-GLI-01343-000-t2f.nii.gz,../../DataSet/ASNR-MICCAI-BraTS2023-GLI-Challenge-TrainingData/BraTS-GLI-01343-000/BraTS-GLI-01343-000-t1n.nii.gz,../../DataSet/ASNR-MICCAI-BraTS2023-GLI-Challenge-TrainingData/BraTS-GLI-01343-000/BraTS-GLI-01343-000-seg.nii.gz,105,101,94,72,139,54,146,55,139,67,92,84
00481-001,../../DataSet/ASNR-MICCAI-BraTS2023-GLI-Challenge-TrainingData/BraTS-GLI-00481-001/BraTS-GLI-00481-001-t1c.nii.gz,../../DataSet/ASNR-MICCAI-BraTS2023-GLI-Challenge-TrainingData/BraTS-GLI-00481-001/BraTS-GLI-00481-001-t2w.nii.gz,../../DataSet/ASNR-MICCAI-BraTS2023-GLI-Challenge-TrainingData/BraTS-GLI-00481-001/BraTS-GLI-00481-001-t2f.nii.gz,../../DataSet/ASNR-MICCAI-BraTS2023-GLI-Challenge-TrainingData/BraTS-GLI-00481-001/BraTS-GLI-00481-001-t1n.nii.gz,../../DataSet/ASNR-MICCAI-BraTS2023-GLI-Challenge-TrainingData/BraTS-GLI-00481-001/BraTS-GLI-00481-001-seg.nii.gz,98,93,89,67,132,49,131,56,129,65,82,73
01395-000,../../DataSet/ASNR-MICCAI-BraTS2023-GLI-Challenge-TrainingData/BraTS-GLI-01395-000/BraTS-GLI-01395-000-t1c.nii.gz,../../DataSet/ASNR-MICCAI-BraTS2023-GLI-Challenge-TrainingData/BraTS-GLI-01395-000/BraTS-GLI-01395-000-t2w.nii.gz,../../DataSet/ASNR-MICCAI-BraTS2023-GLI-Challenge-TrainingData/BraTS-GLI-01395-000/BraTS-GLI-01395-000-t2f.nii.gz,../../DataSet/ASNR-MICCAI-BraTS2023-GLI-Challenge-TrainingData/BraTS-GLI-01395-000/BraTS-GLI-01395-000-t1n.nii.gz,../../DataSet/ASNR-MICCAI-BraTS2023-GLI-Challenge-TrainingData/BraTS-GLI-01395-000/BraTS-GLI-01395-000-seg.nii.gz,168,159,80,147,186,138,180,62,102,39,42,40
00036-001,../../DataSet/ASNR-MICCAI-BraTS2023-GLI-Challenge-TrainingData/BraTS-GLI-00036-001/BraTS-GLI-00036-001-t1c.nii.gz,../../DataSet/ASNR-MICCAI-BraTS2023-GLI-Challenge-TrainingData/BraTS-GLI-00036-001/BraTS-GLI-00036-001-t2w.nii.gz,../../DataSet/ASNR-MICCAI-BraTS2023-GLI-Challenge-TrainingData/BraTS-GLI-00036-001/BraTS-GLI-00036-001-t2f.nii.gz,../../DataSet/ASNR-MICCAI-BraTS2023-GLI-Challenge-TrainingData/BraTS-GLI-00036-001/BraTS-GLI-00036-001-t1n.nii.gz,../../DataSet/ASNR-MICCAI-BraTS2023-GLI-Challenge-TrainingData/BraTS-GLI-00036-001/BraTS-GLI-00036-001-seg.nii.gz,145,77,78,114,179,31,127,39,116,65,96,77
00613-000,../../DataSet/ASNR-MICCAI-BraTS2023-GLI-Challenge-TrainingData/BraTS-GLI-00613-000/BraTS-GLI-00613-000-t1c.nii.gz,../../DataSet/ASNR-MICCAI-BraTS2023-GLI-Challenge-TrainingData/BraTS-GLI-00613-000/BraTS-GLI-00613-000-t2w.nii.gz,../../DataSet/ASNR-MICCAI-BraTS2023-GLI-Challenge-TrainingData/BraTS-GLI-00613-000/BraTS-GLI-00613-000-t2f.nii.gz,../../DataSet/ASNR-MICCAI-BraTS2023-GLI-Challenge-TrainingData/BraTS-GLI-00613-000/BraTS-GLI-00613-000-t1n.nii.gz,../../DataSet/ASNR-MICCAI-BraTS2023-GLI-Challenge-TrainingData/BraTS-GLI-00613-000/BraTS-GLI-00613-000-seg.nii.gz,136,137,112,109,172,91,186,78,143,63,95,65
01082-000,../../DataSet/ASNR-MICCAI-BraTS2023-GLI-Challenge-TrainingData/BraTS-GLI-01082-000/BraTS-GLI-01082-000-t1c.nii.gz,../../DataSet/ASNR-MICCAI-BraTS2023-GLI-Challenge-TrainingData/BraTS-GLI-01082-000/BraTS-GLI-01082-000-t2w.nii.gz,../../DataSet/ASNR-MICCAI-BraTS2023-GLI-Challenge-TrainingData/BraTS-GLI-01082-000/BraTS-GLI-01082-000-t2f.nii.gz,../../DataSet/ASNR-MICCAI-BraTS2023-GLI-Challenge-TrainingData/BraTS-GLI-01082-000/BraTS-GLI-01082-000-t1n.nii.gz,../../DataSet/ASNR-MICCAI-BraTS2023-GLI-Challenge-TrainingData/BraTS-GLI-01082-000/BraTS-GLI-01082-000-seg.nii.gz,151,169,58,126,181,116,210,29,95,55,94,66
00165-000,../../DataSet/ASNR-MICCAI-BraTS2023-GLI-Challenge-TrainingData/BraTS-GLI-00165-000/BraTS-GLI-00165-000-t1c.nii.gz,../../DataSet/ASNR-MICCAI-BraTS2023-GLI-Challenge-TrainingData/BraTS-GLI-00165-000/BraTS-GLI-00165-000-t2w.nii.gz,../../DataSet/ASNR-MICCAI-BraTS2023-GLI-Challenge-TrainingData/BraTS-GLI-00165-000/BraTS-GLI-00165-000-t2f.nii.gz,../../DataSet/ASNR-MICCAI-BraTS2023-GLI-Challenge-TrainingData/BraTS-GLI-00165-000/BraTS-GLI-00165-000-t1n.nii.gz,../../DataSet/ASNR-MICCAI-BraTS2023-GLI-Challenge-TrainingData/BraTS-GLI-00165-000/BraTS-GLI-00165-000-seg.nii.gz,137,125,101,90,165,98,152,72,135,75,54,63
00504-000,../../DataSet/ASNR-MICCAI-BraTS2023-GLI-Challenge-TrainingData/BraTS-GLI-00504-000/BraTS-GLI-00504-000-t1c.nii.gz,../../DataSet/ASNR-MICCAI-BraTS2023-GLI-Challenge-TrainingData/BraTS-GLI-00504-000/BraTS-GLI-00504-000-t2w.nii.gz,../../DataSet/ASNR-MICCAI-BraTS2023-GLI-Challenge-TrainingData/BraTS-GLI-00504-000/BraTS-GLI-00504-000-t2f.nii.gz,../../DataSet/ASNR-MICCAI-BraTS2023-GLI-Challenge-TrainingData/BraTS-GLI-00504-000/BraTS-GLI-00504-000-t1n.nii.gz,../../DataSet/ASNR-MICCAI-BraTS2023-GLI-Challenge-TrainingData/BraTS-GLI-00504-000/BraTS-GLI-00504-000-seg.nii.gz,105,81,101,78,128,41,121,73,136,50,80,63
01344-000,../../DataSet/ASNR-MICCAI-BraTS2023-GLI-Challenge-TrainingData/BraTS-GLI-01344-000/BraTS-GLI-01344-000-t1c.nii.gz,../../DataSet/ASNR-MICCAI-BraTS2023-GLI-Challenge-TrainingData/BraTS-GLI-01344-000/BraTS-GLI-01344-000-t2w.nii.gz,../../DataSet/ASNR-MICCAI-BraTS2023-GLI-Challenge-TrainingData/BraTS-GLI-01344-000/BraTS-GLI-01344-000-t2f.nii.gz,../../DataSet/ASNR-MICCAI-BraTS2023-GLI-Challenge-TrainingData/BraTS-GLI-01344-000/BraTS-GLI-01344-000-t1n.nii.gz,../../DataSet/ASNR-MICCAI-BraTS2023-GLI-Challenge-TrainingData/BraTS-GLI-01344-000/BraTS-GLI-01344-000-seg.nii.gz,109,143,122,100,123,122,160,103,141,23,38,38
00387-000,../../DataSet/ASNR-MICCAI-BraTS2023-GLI-Challenge-TrainingData/BraTS-GLI-00387-000/BraTS-GLI-00387-000-t1c.nii.gz,../../DataSet/ASNR-MICCAI-BraTS2023-GLI-Challenge-TrainingData/BraTS-GLI-00387-000/BraTS-GLI-00387-000-t2w.nii.gz,../../DataSet/ASNR-MICCAI-BraTS2023-GLI-Challenge-TrainingData/BraTS-GLI-00387-000/BraTS-GLI-00387-000-t2f.nii.gz,../../DataSet/ASNR-MICCAI-BraTS2023-GLI-Challenge-TrainingData/BraTS-GLI-00387-000/BraTS-GLI-00387-000-t1n.nii.gz,../../DataSet/ASNR-MICCAI-BraTS2023-GLI-Challenge-TrainingData/BraTS-GLI-00387-000/BraTS-GLI-00387-000-seg.nii.gz,116,134,50,97,142,86,170,27,92,45,84,65
01260-000,../../DataSet/ASNR-MICCAI-BraTS2023-GLI-Challenge-TrainingData/BraTS-GLI-01260-000/BraTS-GLI-01260-000-t1c.nii.gz,../../DataSet/ASNR-MICCAI-BraTS2023-GLI-Challenge-TrainingData/BraTS-GLI-01260-000/BraTS-GLI-01260-000-t2w.nii.gz,../../DataSet/ASNR-MICCAI-BraTS2023-GLI-Challenge-TrainingData/BraTS-GLI-01260-000/BraTS-GLI-01260-000-t2f.nii.gz,../../DataSet/ASNR-MICCAI-BraTS2023-GLI-Challenge-TrainingData/BraTS-GLI-01260-000/BraTS-GLI-01260-000-t1n.nii.gz,../../DataSet/ASNR-MICCAI-BraTS2023-GLI-Challenge-TrainingData/BraTS-GLI-01260-000/BraTS-GLI-01260-000-seg.nii.gz,143,162,94,114,178,117,204,48,139,64,87,91
01516-000,../../DataSet/ASNR-MICCAI-BraTS2023-GLI-Challenge-TrainingData/BraTS-GLI-01516-000/BraTS-GLI-01516-000-t1c.nii.gz,../../DataSet/ASNR-MICCAI-BraTS2023-GLI-Challenge-TrainingData/BraTS-GLI-01516-000/BraTS-GLI-01516-000-t2w.nii.gz,../../DataSet/ASNR-MICCAI-BraTS2023-GLI-Challenge-TrainingData/BraTS-GLI-01516-000/BraTS-GLI-01516-000-t2f.nii.gz,../../DataSet/ASNR-MICCAI-BraTS2023-GLI-Challenge-TrainingData/BraTS-GLI-01516-000/BraTS-GLI-01516-000-t1n.nii.gz,../../DataSet/ASNR-MICCAI-BraTS2023-GLI-Challenge-TrainingData/BraTS-GLI-01516-000/BraTS-GLI-01516-000-seg.nii.gz,150,128,111,128,174,101,156,92,130,46,55,38
00356-000,../../DataSet/ASNR-MICCAI-BraTS2023-GLI-Challenge-TrainingData/BraTS-GLI-00356-000/BraTS-GLI-00356-000-t1c.nii.gz,../../DataSet/ASNR-MICCAI-BraTS2023-GLI-Challenge-TrainingData/BraTS-GLI-00356-000/BraTS-GLI-00356-000-t2w.nii.gz,../../DataSet/ASNR-MICCAI-BraTS2023-GLI-Challenge-TrainingData/BraTS-GLI-00356-000/BraTS-GLI-00356-000-t2f.nii.gz,../../DataSet/ASNR-MICCAI-BraTS2023-GLI-Challenge-TrainingData/BraTS-GLI-00356-000/BraTS-GLI-00356-000-t1n.nii.gz,../../DataSet/ASNR-MICCAI-BraTS2023-GLI-Challenge-TrainingData/BraTS-GLI-00356-000/BraTS-GLI-00356-000-seg.nii.gz,102,137,74,78,125,116,157,56,98,47,41,42
00737-000,../../DataSet/ASNR-MICCAI-BraTS2023-GLI-Challenge-TrainingData/BraTS-GLI-00737-000/BraTS-GLI-00737-000-t1c.nii.gz,../../DataSet/ASNR-MICCAI-BraTS2023-GLI-Challenge-TrainingData/BraTS-GLI-00737-000/BraTS-GLI-00737-000-t2w.nii.gz,../../DataSet/ASNR-MICCAI-BraTS2023-GLI-Challenge-TrainingData/BraTS-GLI-00737-000/BraTS-GLI-00737-000-t2f.nii.gz,../../DataSet/ASNR-MICCAI-BraTS2023-GLI-Challenge-TrainingData/BraTS-GLI-00737-000/BraTS-GLI-00737-000-t1n.nii.gz,../../DataSet/ASNR-MICCAI-BraTS2023-GLI-Challenge-TrainingData/BraTS-GLI-00737-000/BraTS-GLI-00737-000-seg.nii.gz,147,127,97,97,170,95,149,77,117,73,54,40
00090-000,../../DataSet/ASNR-MICCAI-BraTS2023-GLI-Challenge-TrainingData/BraTS-GLI-00090-000/BraTS-GLI-00090-000-t1c.nii.gz,../../DataSet/ASNR-MICCAI-BraTS2023-GLI-Challenge-TrainingData/BraTS-GLI-00090-000/BraTS-GLI-00090-000-t2w.nii.gz,../../DataSet/ASNR-MICCAI-BraTS2023-GLI-Challenge-TrainingData/BraTS-GLI-00090-000/BraTS-GLI-00090-000-t2f.nii.gz,../../DataSet/ASNR-MICCAI-BraTS2023-GLI-Challenge-TrainingData/BraTS-GLI-00090-000/BraTS-GLI-00090-000-t1n.nii.gz,../../DataSet/ASNR-MICCAI-BraTS2023-GLI-Challenge-TrainingData/BraTS-GLI-00090-000/BraTS-GLI-00090-000-seg.nii.gz,156,131,72,118,186,93,164,36,104,68,71,68
01338-000,../../DataSet/ASNR-MICCAI-BraTS2023-GLI-Challenge-TrainingData/BraTS-GLI-01338-000/BraTS-GLI-01338-000-t1c.nii.gz,../../DataSet/ASNR-MICCAI-BraTS2023-GLI-Challenge-TrainingData/BraTS-GLI-01338-000/BraTS-GLI-01338-000-t2w.nii.gz,../../DataSet/ASNR-MICCAI-BraTS2023-GLI-Challenge-TrainingData/BraTS-GLI-01338-000/BraTS-GLI-01338-000-t2f.nii.gz,../../DataSet/ASNR-MICCAI-BraTS2023-GLI-Challenge-TrainingData/BraTS-GLI-01338-000/BraTS-GLI-01338-000-t1n.nii.gz,../../DataSet/ASNR-MICCAI-BraTS2023-GLI-Challenge-TrainingData/BraTS-GLI-01338-000/BraTS-GLI-01338-000-seg.nii.gz,122,102,81,88,164,66,156,53,119,76,90,66
01212-000,../../DataSet/ASNR-MICCAI-BraTS2023-GLI-Challenge-TrainingData/BraTS-GLI-01212-000/BraTS-GLI-01212-000-t1c.nii.gz,../../DataSet/ASNR-MICCAI-BraTS2023-GLI-Challenge-TrainingData/BraTS-GLI-01212-000/BraTS-GLI-01212-000-t2w.nii.gz,../../DataSet/ASNR-MICCAI-BraTS2023-GLI-Challenge-TrainingData/BraTS-GLI-01212-000/BraTS-GLI-01212-000-t2f.nii.gz,../../DataSet/ASNR-MICCAI-BraTS2023-GLI-Challenge-TrainingData/BraTS-GLI-01212-000/BraTS-GLI-01212-000-t1n.nii.gz,../../DataSet/ASNR-MICCAI-BraTS2023-GLI-Challenge-TrainingData/BraTS-GLI-01212-000/BraTS-GLI-01212-000-seg.nii.gz,167,124,64,148,187,89,164,37,91,39,75,54
00820-000,../../DataSet/ASNR-MICCAI-BraTS2023-GLI-Challenge-TrainingData/BraTS-GLI-00820-000/BraTS-GLI-00820-000-t1c.nii.gz,../../DataSet/ASNR-MICCAI-BraTS2023-GLI-Challenge-TrainingData/BraTS-GLI-00820-000/BraTS-GLI-00820-000-t2w.nii.gz,../../DataSet/ASNR-MICCAI-BraTS2023-GLI-Challenge-TrainingData/BraTS-GLI-00820-000/BraTS-GLI-00820-000-t2f.nii.gz,../../DataSet/ASNR-MICCAI-BraTS2023-GLI-Challenge-TrainingData/BraTS-GLI-00820-000/BraTS-GLI-00820-000-t1n.nii.gz,../../DataSet/ASNR-MICCAI-BraTS2023-GLI-Challenge-TrainingData/BraTS-GLI-00820-000/BraTS-GLI-00820-000-seg.nii.gz,99,124,71,61,125,105,148,35,110,64,43,75
00483-000,../../DataSet/ASNR-MICCAI-BraTS2023-GLI-Challenge-TrainingData/BraTS-GLI-00483-000/BraTS-GLI-00483-000-t1c.nii.gz,../../DataSet/ASNR-MICCAI-BraTS2023-GLI-Challenge-TrainingData/BraTS-GLI-00483-000/BraTS-GLI-00483-000-t2w.nii.gz,../../DataSet/ASNR-MICCAI-BraTS2023-GLI-Challenge-TrainingData/BraTS-GLI-00483-000/BraTS-GLI-00483-000-t2f.nii.gz,../../DataSet/ASNR-MICCAI-BraTS2023-GLI-Challenge-TrainingData/BraTS-GLI-00483-000/BraTS-GLI-00483-000-t1n.nii.gz,../../DataSet/ASNR-MICCAI-BraTS2023-GLI-Challenge-TrainingData/BraTS-GLI-00483-000/BraTS-GLI-00483-000-seg.nii.gz,91,130,75,54,130,82,176,32,115,76,94,83
00324-000,../../DataSet/ASNR-MICCAI-BraTS2023-GLI-Challenge-TrainingData/BraTS-GLI-00324-000/BraTS-GLI-00324-000-t1c.nii.gz,../../DataSet/ASNR-MICCAI-BraTS2023-GLI-Challenge-TrainingData/BraTS-GLI-00324-000/BraTS-GLI-00324-000-t2w.nii.gz,../../DataSet/ASNR-MICCAI-BraTS2023-GLI-Challenge-TrainingData/BraTS-GLI-00324-000/BraTS-GLI-00324-000-t2f.nii.gz,../../DataSet/ASNR-MICCAI-BraTS2023-GLI-Challenge-TrainingData/BraTS-GLI-00324-000/BraTS-GLI-00324-000-t1n.nii.gz,../../DataSet/ASNR-MICCAI-BraTS2023-GLI-Challenge-TrainingData/BraTS-GLI-00324-000/BraTS-GLI-00324-000-seg.nii.gz,141,177,90,117,168,148,213,53,128,51,65,75
01105-000,../../DataSet/ASNR-MICCAI-BraTS2023-GLI-Challenge-TrainingData/BraTS-GLI-01105-000/BraTS-GLI-01105-000-t1c.nii.gz,../../DataSet/ASNR-MICCAI-BraTS2023-GLI-Challenge-TrainingData/BraTS-GLI-01105-000/BraTS-GLI-01105-000-t2w.nii.gz,../../DataSet/ASNR-MICCAI-BraTS2023-GLI-Challenge-TrainingData/BraTS-GLI-01105-000/BraTS-GLI-01105-000-t2f.nii.gz,../../DataSet/ASNR-MICCAI-BraTS2023-GLI-Challenge-TrainingData/BraTS-GLI-01105-000/BraTS-GLI-01105-000-t1n.nii.gz,../../DataSet/ASNR-MICCAI-BraTS2023-GLI-Challenge-TrainingData/BraTS-GLI-01105-000/BraTS-GLI-01105-000-seg.nii.gz,162,141,63,125,192,93,188,29,102,67,95,73
00389-000,../../DataSet/ASNR-MICCAI-BraTS2023-GLI-Challenge-TrainingData/BraTS-GLI-00389-000/BraTS-GLI-00389-000-t1c.nii.gz,../../DataSet/ASNR-MICCAI-BraTS2023-GLI-Challenge-TrainingData/BraTS-GLI-00389-000/BraTS-GLI-00389-000-t2w.nii.gz,../../DataSet/ASNR-MICCAI-BraTS2023-GLI-Challenge-TrainingData/BraTS-GLI-00389-000/BraTS-GLI-00389-000-t2f.nii.gz,../../DataSet/ASNR-MICCAI-BraTS2023-GLI-Challenge-TrainingData/BraTS-GLI-00389-000/BraTS-GLI-00389-000-t1n.nii.gz,../../DataSet/ASNR-MICCAI-BraTS2023-GLI-Challenge-TrainingData/BraTS-GLI-00389-000/BraTS-GLI-00389-000-seg.nii.gz,168,136,85,152,186,120,154,69,102,34,34,33
01179-000,../../DataSet/ASNR-MICCAI-BraTS2023-GLI-Challenge-TrainingData/BraTS-GLI-01179-000/BraTS-GLI-01179-000-t1c.nii.gz,../../DataSet/ASNR-MICCAI-BraTS2023-GLI-Challenge-TrainingData/BraTS-GLI-01179-000/BraTS-GLI-01179-000-t2w.nii.gz,../../DataSet/ASNR-MICCAI-BraTS2023-GLI-Challenge-TrainingData/BraTS-GLI-01179-000/BraTS-GLI-01179-000-t2f.nii.gz,../../DataSet/ASNR-MICCAI-BraTS2023-GLI-Challenge-TrainingData/BraTS-GLI-01179-000/BraTS-GLI-01179-000-t1n.nii.gz,../../DataSet/ASNR-MICCAI-BraTS2023-GLI-Challenge-TrainingData/BraTS-GLI-01179-000/BraTS-GLI-01179-000-seg.nii.gz,156,115,55,126,189,77,173,24,100,63,96,76
01440-000,../../DataSet/ASNR-MICCAI-BraTS2023-GLI-Challenge-TrainingData/BraTS-GLI-01440-000/BraTS-GLI-01440-000-t1c.nii.gz,../../DataSet/ASNR-MICCAI-BraTS2023-GLI-Challenge-TrainingData/BraTS-GLI-01440-000/BraTS-GLI-01440-000-t2w.nii.gz,../../DataSet/ASNR-MICCAI-BraTS2023-GLI-Challenge-TrainingData/BraTS-GLI-01440-000/BraTS-GLI-01440-000-t2f.nii.gz,../../DataSet/ASNR-MICCAI-BraTS2023-GLI-Challenge-TrainingData/BraTS-GLI-01440-000/BraTS-GLI-01440-000-t1n.nii.gz,../../DataSet/ASNR-MICCAI-BraTS2023-GLI-Challenge-TrainingData/BraTS-GLI-01440-000/BraTS-GLI-01440-000-seg.nii.gz,138,74,91,120,158,50,98,71,114,38,48,43
00661-000,../../DataSet/ASNR-MICCAI-BraTS2023-GLI-Challenge-TrainingData/BraTS-GLI-00661-000/BraTS-GLI-00661-000-t1c.nii.gz,../../DataSet/ASNR-MICCAI-BraTS2023-GLI-Challenge-TrainingData/BraTS-GLI-00661-000/BraTS-GLI-00661-000-t2w.nii.gz,../../DataSet/ASNR-MICCAI-BraTS2023-GLI-Challenge-TrainingData/BraTS-GLI-00661-000/BraTS-GLI-00661-000-t2f.nii.gz,../../DataSet/ASNR-MICCAI-BraTS2023-GLI-Challenge-TrainingData/BraTS-GLI-00661-000/BraTS-GLI-00661-000-t1n.nii.gz,../../DataSet/ASNR-MICCAI-BraTS2023-GLI-Challenge-TrainingData/BraTS-GLI-00661-000/BraTS-GLI-00661-000-seg.nii.gz,149,158,96,115,180,119,201,58,136,65,82,78
00732-001,../../DataSet/ASNR-MICCAI-BraTS2023-GLI-Challenge-TrainingData/BraTS-GLI-00732-001/BraTS-GLI-00732-001-t1c.nii.gz,../../DataSet/ASNR-MICCAI-BraTS2023-GLI-Challenge-TrainingData/BraTS-GLI-00732-001/BraTS-GLI-00732-001-t2w.nii.gz,../../DataSet/ASNR-MICCAI-BraTS2023-GLI-Challenge-TrainingData/BraTS-GLI-00732-001/BraTS-GLI-00732-001-t2f.nii.gz,../../DataSet/ASNR-MICCAI-BraTS2023-GLI-Challenge-TrainingData/BraTS-GLI-00732-001/BraTS-GLI-00732-001-t1n.nii.gz,../../DataSet/ASNR-MICCAI-BraTS2023-GLI-Challenge-TrainingData/BraTS-GLI-00732-001/BraTS-GLI-00732-001-seg.nii.gz,165,151,63,153,175,131,187,51,75,22,56,24
00117-000,../../DataSet/ASNR-MICCAI-BraTS2023-GLI-Challenge-TrainingData/BraTS-GLI-00117-000/BraTS-GLI-00117-000-t1c.nii.gz,../../DataSet/ASNR-MICCAI-BraTS2023-GLI-Challenge-TrainingData/BraTS-GLI-00117-000/BraTS-GLI-00117-000-t2w.nii.gz,../../DataSet/ASNR-MICCAI-BraTS2023-GLI-Challenge-TrainingData/BraTS-GLI-00117-000/BraTS-GLI-00117-000-t2f.nii.gz,../../DataSet/ASNR-MICCAI-BraTS2023-GLI-Challenge-TrainingData/BraTS-GLI-00117-000/BraTS-GLI-00117-000-t1n.nii.gz,../../DataSet/ASNR-MICCAI-BraTS2023-GLI-Challenge-TrainingData/BraTS-GLI-00117-000/BraTS-GLI-00117-000-seg.nii.gz,104,150,96,59,134,103,188,61,132,75,85,71
01491-000,../../DataSet/ASNR-MICCAI-BraTS2023-GLI-Challenge-TrainingData/BraTS-GLI-01491-000/BraTS-GLI-01491-000-t1c.nii.gz,../../DataSet/ASNR-MICCAI-BraTS2023-GLI-Challenge-TrainingData/BraTS-GLI-01491-000/BraTS-GLI-01491-000-t2w.nii.gz,../../DataSet/ASNR-MICCAI-BraTS2023-GLI-Challenge-TrainingData/BraTS-GLI-01491-000/BraTS-GLI-01491-000-t2f.nii.gz,../../DataSet/ASNR-MICCAI-BraTS2023-GLI-Challenge-TrainingData/BraTS-GLI-01491-000/BraTS-GLI-01491-000-t1n.nii.gz,../../DataSet/ASNR-MICCAI-BraTS2023-GLI-Challenge-TrainingData/BraTS-GLI-01491-000/BraTS-GLI-01491-000-seg.nii.gz,132,75,88,119,149,55,95,61,120,30,40,59
01336-000,../../DataSet/ASNR-MICCAI-BraTS2023-GLI-Challenge-TrainingData/BraTS-GLI-01336-000/BraTS-GLI-01336-000-t1c.nii.gz,../../DataSet/ASNR-MICCAI-BraTS2023-GLI-Challenge-TrainingData/BraTS-GLI-01336-000/BraTS-GLI-01336-000-t2w.nii.gz,../../DataSet/ASNR-MICCAI-BraTS2023-GLI-Challenge-TrainingData/BraTS-GLI-01336-000/BraTS-GLI-01336-000-t2f.nii.gz,../../DataSet/ASNR-MICCAI-BraTS2023-GLI-Challenge-TrainingData/BraTS-GLI-01336-000/BraTS-GLI-01336-000-t1n.nii.gz,../../DataSet/ASNR-MICCAI-BraTS2023-GLI-Challenge-TrainingData/BraTS-GLI-01336-000/BraTS-GLI-01336-000-seg.nii.gz,155,106,91,129,181,78,135,63,118,52,57,55
00576-000,../../DataSet/ASNR-MICCAI-BraTS2023-GLI-Challenge-TrainingData/BraTS-GLI-00576-000/BraTS-GLI-00576-000-t1c.nii.gz,../../DataSet/ASNR-MICCAI-BraTS2023-GLI-Challenge-TrainingData/BraTS-GLI-00576-000/BraTS-GLI-00576-000-t2w.nii.gz,../../DataSet/ASNR-MICCAI-BraTS2023-GLI-Challenge-TrainingData/BraTS-GLI-00576-000/BraTS-GLI-00576-000-t2f.nii.gz,../../DataSet/ASNR-MICCAI-BraTS2023-GLI-Challenge-TrainingData/BraTS-GLI-00576-000/BraTS-GLI-00576-000-t1n.nii.gz,../../DataSet/ASNR-MICCAI-BraTS2023-GLI-Challenge-TrainingData/BraTS-GLI-00576-000/BraTS-GLI-00576-000-seg.nii.gz,158,144,65,128,182,103,187,39,90,54,84,51
00048-000,../../DataSet/ASNR-MICCAI-BraTS2023-GLI-Challenge-TrainingData/BraTS-GLI-00048-000/BraTS-GLI-00048-000-t1c.nii.gz,../../DataSet/ASNR-MICCAI-BraTS2023-GLI-Challenge-TrainingData/BraTS-GLI-00048-000/BraTS-GLI-00048-000-t2w.nii.gz,../../DataSet/ASNR-MICCAI-BraTS2023-GLI-Challenge-TrainingData/BraTS-GLI-00048-000/BraTS-GLI-00048-000-t2f.nii.gz,../../DataSet/ASNR-MICCAI-BraTS2023-GLI-Challenge-TrainingData/BraTS-GLI-00048-000/BraTS-GLI-00048-000-t1n.nii.gz,../../DataSet/ASNR-MICCAI-BraTS2023-GLI-Challenge-TrainingData/BraTS-GLI-00048-000/BraTS-GLI-00048-000-seg.nii.gz,156,173,72,136,180,133,208,43,109,44,75,66
00099-000,../../DataSet/ASNR-MICCAI-BraTS2023-GLI-Challenge-TrainingData/BraTS-GLI-00099-000/BraTS-GLI-00099-000-t1c.nii.gz,../../DataSet/ASNR-MICCAI-BraTS2023-GLI-Challenge-TrainingData/BraTS-GLI-00099-000/BraTS-GLI-00099-000-t2w.nii.gz,../../DataSet/ASNR-MICCAI-BraTS2023-GLI-Challenge-TrainingData/BraTS-GLI-00099-000/BraTS-GLI-00099-000-t2f.nii.gz,../../DataSet/ASNR-MICCAI-BraTS2023-GLI-Challenge-TrainingData/BraTS-GLI-00099-000/BraTS-GLI-00099-000-t1n.nii.gz,../../DataSet/ASNR-MICCAI-BraTS2023-GLI-Challenge-TrainingData/BraTS-GLI-00099-000/BraTS-GLI-00099-000-seg.nii.gz,94,159,85,63,143,125,192,41,124,80,67,83
01447-000,../../DataSet/ASNR-MICCAI-BraTS2023-GLI-Challenge-TrainingData/BraTS-GLI-01447-000/BraTS-GLI-01447-000-t1c.nii.gz,../../DataSet/ASNR-MICCAI-BraTS2023-GLI-Challenge-TrainingData/BraTS-GLI-01447-000/BraTS-GLI-01447-000-t2w.nii.gz,../../DataSet/ASNR-MICCAI-BraTS2023-GLI-Challenge-TrainingData/BraTS-GLI-01447-000/BraTS-GLI-01447-000-t2f.nii.gz,../../DataSet/ASNR-MICCAI-BraTS2023-GLI-Challenge-TrainingData/BraTS-GLI-01447-000/BraTS-GLI-01447-000-t1n.nii.gz,../../DataSet/ASNR-MICCAI-BraTS2023-GLI-Challenge-TrainingData/BraTS-GLI-01447-000/BraTS-GLI-01447-000-seg.nii.gz,97,163,98,71,119,129,199,69,129,48,70,60
01026-000,../../DataSet/ASNR-MICCAI-BraTS2023-GLI-Challenge-TrainingData/BraTS-GLI-01026-000/BraTS-GLI-01026-000-t1c.nii.gz,../../DataSet/ASNR-MICCAI-BraTS2023-GLI-Challenge-TrainingData/BraTS-GLI-01026-000/BraTS-GLI-01026-000-t2w.nii.gz,../../DataSet/ASNR-MICCAI-BraTS2023-GLI-Challenge-TrainingData/BraTS-GLI-01026-000/BraTS-GLI-01026-000-t2f.nii.gz,../../DataSet/ASNR-MICCAI-BraTS2023-GLI-Challenge-TrainingData/BraTS-GLI-01026-000/BraTS-GLI-01026-000-t1n.nii.gz,../../DataSet/ASNR-MICCAI-BraTS2023-GLI-Challenge-TrainingData/BraTS-GLI-01026-000/BraTS-GLI-01026-000-seg.nii.gz,146,95,84,108,181,46,142,46,125,73,96,79
00735-001,../../DataSet/ASNR-MICCAI-BraTS2023-GLI-Challenge-TrainingData/BraTS-GLI-00735-001/BraTS-GLI-00735-001-t1c.nii.gz,../../DataSet/ASNR-MICCAI-BraTS2023-GLI-Challenge-TrainingData/BraTS-GLI-00735-001/BraTS-GLI-00735-001-t2w.nii.gz,../../DataSet/ASNR-MICCAI-BraTS2023-GLI-Challenge-TrainingData/BraTS-GLI-00735-001/BraTS-GLI-00735-001-t2f.nii.gz,../../DataSet/ASNR-MICCAI-BraTS2023-GLI-Challenge-TrainingData/BraTS-GLI-00735-001/BraTS-GLI-00735-001-t1n.nii.gz,../../DataSet/ASNR-MICCAI-BraTS2023-GLI-Challenge-TrainingData/BraTS-GLI-00735-001/BraTS-GLI-00735-001-seg.nii.gz,151,105,53,129,168,59,135,29,80,39,76,51
00110-000,../../DataSet/ASNR-MICCAI-BraTS2023-GLI-Challenge-TrainingData/BraTS-GLI-00110-000/BraTS-GLI-00110-000-t1c.nii.gz,../../DataSet/ASNR-MICCAI-BraTS2023-GLI-Challenge-TrainingData/BraTS-GLI-00110-000/BraTS-GLI-00110-000-t2w.nii.gz,../../DataSet/ASNR-MICCAI-BraTS2023-GLI-Challenge-TrainingData/BraTS-GLI-00110-000/BraTS-GLI-00110-000-t2f.nii.gz,../../DataSet/ASNR-MICCAI-BraTS2023-GLI-Challenge-TrainingData/BraTS-GLI-00110-000/BraTS-GLI-00110-000-t1n.nii.gz,../../DataSet/ASNR-MICCAI-BraTS2023-GLI-Challenge-TrainingData/BraTS-GLI-00110-000/BraTS-GLI-00110-000-seg.nii.gz,143,114,102,121,170,76,155,68,134,49,79,66
00571-000,../../DataSet/ASNR-MICCAI-BraTS2023-GLI-Challenge-TrainingData/BraTS-GLI-00571-000/BraTS-GLI-00571-000-t1c.nii.gz,../../DataSet/ASNR-MICCAI-BraTS2023-GLI-Challenge-TrainingData/BraTS-GLI-00571-000/BraTS-GLI-00571-000-t2w.nii.gz,../../DataSet/ASNR-MICCAI-BraTS2023-GLI-Challenge-TrainingData/BraTS-GLI-00571-000/BraTS-GLI-00571-000-t2f.nii.gz,../../DataSet/ASNR-MICCAI-BraTS2023-GLI-Challenge-TrainingData/BraTS-GLI-00571-000/BraTS-GLI-00571-000-t1n.nii.gz,../../DataSet/ASNR-MICCAI-BraTS2023-GLI-Challenge-TrainingData/BraTS-GLI-00571-000/BraTS-GLI-00571-000-seg.nii.gz,144,180,91,123,169,141,216,70,113,46,75,43
01331-000,../../DataSet/ASNR-MICCAI-BraTS2023-GLI-Challenge-TrainingData/BraTS-GLI-01331-000/BraTS-GLI-01331-000-t1c.nii.gz,../../DataSet/ASNR-MICCAI-BraTS2023-GLI-Challenge-TrainingData/BraTS-GLI-01331-000/BraTS-GLI-01331-000-t2w.nii.gz,../../DataSet/ASNR-MICCAI-BraTS2023-GLI-Challenge-TrainingData/BraTS-GLI-01331-000/BraTS-GLI-01331-000-t2f.nii.gz,../../DataSet/ASNR-MICCAI-BraTS2023-GLI-Challenge-TrainingData/BraTS-GLI-01331-000/BraTS-GLI-01331-000-t1n.nii.gz,../../DataSet/ASNR-MICCAI-BraTS2023-GLI-Challenge-TrainingData/BraTS-GLI-01331-000/BraTS-GLI-01331-000-seg.nii.gz,132,158,39,104,170,125,195,8,72,66,70,64
00793-000,../../DataSet/ASNR-MICCAI-BraTS2023-GLI-Challenge-TrainingData/BraTS-GLI-00793-000/BraTS-GLI-00793-000-t1c.nii.gz,../../DataSet/ASNR-MICCAI-BraTS2023-GLI-Challenge-TrainingData/BraTS-GLI-00793-000/BraTS-GLI-00793-000-t2w.nii.gz,../../DataSet/ASNR-MICCAI-BraTS2023-GLI-Challenge-TrainingData/BraTS-GLI-00793-000/BraTS-GLI-00793-000-t2f.nii.gz,../../DataSet/ASNR-MICCAI-BraTS2023-GLI-Challenge-TrainingData/BraTS-GLI-00793-000/BraTS-GLI-00793-000-t1n.nii.gz,../../DataSet/ASNR-MICCAI-BraTS2023-GLI-Challenge-TrainingData/BraTS-GLI-00793-000/BraTS-GLI-00793-000-seg.nii.gz,97,100,95,62,132,58,141,62,134,70,83,72
00611-001,../../DataSet/ASNR-MICCAI-BraTS2023-GLI-Challenge-TrainingData/BraTS-GLI-00611-001/BraTS-GLI-00611-001-t1c.nii.gz,../../DataSet/ASNR-MICCAI-BraTS2023-GLI-Challenge-TrainingData/BraTS-GLI-00611-001/BraTS-GLI-00611-001-t2w.nii.gz,../../DataSet/ASNR-MICCAI-BraTS2023-GLI-Challenge-TrainingData/BraTS-GLI-00611-001/BraTS-GLI-00611-001-t2f.nii.gz,../../DataSet/ASNR-MICCAI-BraTS2023-GLI-Challenge-TrainingData/BraTS-GLI-00611-001/BraTS-GLI-00611-001-t1n.nii.gz,../../DataSet/ASNR-MICCAI-BraTS2023-GLI-Challenge-TrainingData/BraTS-GLI-00611-001/BraTS-GLI-00611-001-seg.nii.gz,158,130,66,130,182,90,181,32,95,52,91,63
00455-000,../../DataSet/ASNR-MICCAI-BraTS2023-GLI-Challenge-TrainingData/BraTS-GLI-00455-000/BraTS-GLI-00455-000-t1c.nii.gz,../../DataSet/ASNR-MICCAI-BraTS2023-GLI-Challenge-TrainingData/BraTS-GLI-00455-000/BraTS-GLI-00455-000-t2w.nii.gz,../../DataSet/ASNR-MICCAI-BraTS2023-GLI-Challenge-TrainingData/BraTS-GLI-00455-000/BraTS-GLI-00455-000-t2f.nii.gz,../../DataSet/ASNR-MICCAI-BraTS2023-GLI-Challenge-TrainingData/BraTS-GLI-00455-000/BraTS-GLI-00455-000-t1n.nii.gz,../../DataSet/ASNR-MICCAI-BraTS2023-GLI-Challenge-TrainingData/BraTS-GLI-00455-000/BraTS-GLI-00455-000-seg.nii.gz,137,124,105,108,170,87,166,78,135,62,79,57
01215-000,../../DataSet/ASNR-MICCAI-BraTS2023-GLI-Challenge-TrainingData/BraTS-GLI-01215-000/BraTS-GLI-01215-000-t1c.nii.gz,../../DataSet/ASNR-MICCAI-BraTS2023-GLI-Challenge-TrainingData/BraTS-GLI-01215-000/BraTS-GLI-01215-000-t2w.nii.gz,../../DataSet/ASNR-MICCAI-BraTS2023-GLI-Challenge-TrainingData/BraTS-GLI-01215-000/BraTS-GLI-01215-000-t2f.nii.gz,../../DataSet/ASNR-MICCAI-BraTS2023-GLI-Challenge-TrainingData/BraTS-GLI-01215-000/BraTS-GLI-01215-000-t1n.nii.gz,../../DataSet/ASNR-MICCAI-BraTS2023-GLI-Challenge-TrainingData/BraTS-GLI-01215-000/BraTS-GLI-01215-000-seg.nii.gz,152,128,78,125,181,82,171,38,116,56,89,78
01102-000,../../DataSet/ASNR-MICCAI-BraTS2023-GLI-Challenge-TrainingData/BraTS-GLI-01102-000/BraTS-GLI-01102-000-t1c.nii.gz,../../DataSet/ASNR-MICCAI-BraTS2023-GLI-Challenge-TrainingData/BraTS-GLI-01102-000/BraTS-GLI-01102-000-t2w.nii.gz,../../DataSet/ASNR-MICCAI-BraTS2023-GLI-Challenge-TrainingData/BraTS-GLI-01102-000/BraTS-GLI-01102-000-t2f.nii.gz,../../DataSet/ASNR-MICCAI-BraTS2023-GLI-Challenge-TrainingData/BraTS-GLI-01102-000/BraTS-GLI-01102-000-t1n.nii.gz,../../DataSet/ASNR-MICCAI-BraTS2023-GLI-Challenge-TrainingData/BraTS-GLI-01102-000/BraTS-GLI-01102-000-seg.nii.gz,101,156,114,81,120,134,185,86,135,39,51,49
00689-001,../../DataSet/ASNR-MICCAI-BraTS2023-GLI-Challenge-TrainingData/BraTS-GLI-00689-001/BraTS-GLI-00689-001-t1c.nii.gz,../../DataSet/ASNR-MICCAI-BraTS2023-GLI-Challenge-TrainingData/BraTS-GLI-00689-001/BraTS-GLI-00689-001-t2w.nii.gz,../../DataSet/ASNR-MICCAI-BraTS2023-GLI-Challenge-TrainingData/BraTS-GLI-00689-001/BraTS-GLI-00689-001-t2f.nii.gz,../../DataSet/ASNR-MICCAI-BraTS2023-GLI-Challenge-TrainingData/BraTS-GLI-00689-001/BraTS-GLI-00689-001-t1n.nii.gz,../../DataSet/ASNR-MICCAI-BraTS2023-GLI-Challenge-TrainingData/BraTS-GLI-00689-001/BraTS-GLI-00689-001-seg.nii.gz,153,132,63,120,184,88,182,27,100,64,94,73
00544-000,../../DataSet/ASNR-MICCAI-BraTS2023-GLI-Challenge-TrainingData/BraTS-GLI-00544-000/BraTS-GLI-00544-000-t1c.nii.gz,../../DataSet/ASNR-MICCAI-BraTS2023-GLI-Challenge-TrainingData/BraTS-GLI-00544-000/BraTS-GLI-00544-000-t2w.nii.gz,../../DataSet/ASNR-MICCAI-BraTS2023-GLI-Challenge-TrainingData/BraTS-GLI-00544-000/BraTS-GLI-00544-000-t2f.nii.gz,../../DataSet/ASNR-MICCAI-BraTS2023-GLI-Challenge-TrainingData/BraTS-GLI-00544-000/BraTS-GLI-00544-000-t1n.nii.gz,../../DataSet/ASNR-MICCAI-BraTS2023-GLI-Challenge-TrainingData/BraTS-GLI-00544-000/BraTS-GLI-00544-000-seg.nii.gz,157,102,46,139,177,79,132,26,76,38,53,50
01304-000,../../DataSet/ASNR-MICCAI-BraTS2023-GLI-Challenge-TrainingData/BraTS-GLI-01304-000/BraTS-GLI-01304-000-t1c.nii.gz,../../DataSet/ASNR-MICCAI-BraTS2023-GLI-Challenge-TrainingData/BraTS-GLI-01304-000/BraTS-GLI-01304-000-t2w.nii.gz,../../DataSet/ASNR-MICCAI-BraTS2023-GLI-Challenge-TrainingData/BraTS-GLI-01304-000/BraTS-GLI-01304-000-t2f.nii.gz,../../DataSet/ASNR-MICCAI-BraTS2023-GLI-Challenge-TrainingData/BraTS-GLI-01304-000/BraTS-GLI-01304-000-t1n.nii.gz,../../DataSet/ASNR-MICCAI-BraTS2023-GLI-Challenge-TrainingData/BraTS-GLI-01304-000/BraTS-GLI-01304-000-seg.nii.gz,88,122,75,60,120,83,163,48,102,60,80,54
00682-000,../../DataSet/ASNR-MICCAI-BraTS2023-GLI-Challenge-TrainingData/BraTS-GLI-00682-000/BraTS-GLI-00682-000-t1c.nii.gz,../../DataSet/ASNR-MICCAI-BraTS2023-GLI-Challenge-TrainingData/BraTS-GLI-00682-000/BraTS-GLI-00682-000-t2w.nii.gz,../../DataSet/ASNR-MICCAI-BraTS2023-GLI-Challenge-TrainingData/BraTS-GLI-00682-000/BraTS-GLI-00682-000-t2f.nii.gz,../../DataSet/ASNR-MICCAI-BraTS2023-GLI-Challenge-TrainingData/BraTS-GLI-00682-000/BraTS-GLI-00682-000-t1n.nii.gz,../../DataSet/ASNR-MICCAI-BraTS2023-GLI-Challenge-TrainingData/BraTS-GLI-00682-000/BraTS-GLI-00682-000-seg.nii.gz,157,142,93,134,184,101,175,64,129,50,74,65
01013-000,../../DataSet/ASNR-MICCAI-BraTS2023-GLI-Challenge-TrainingData/BraTS-GLI-01013-000/BraTS-GLI-01013-000-t1c.nii.gz,../../DataSet/ASNR-MICCAI-BraTS2023-GLI-Challenge-TrainingData/BraTS-GLI-01013-000/BraTS-GLI-01013-000-t2w.nii.gz,../../DataSet/ASNR-MICCAI-BraTS2023-GLI-Challenge-TrainingData/BraTS-GLI-01013-000/BraTS-GLI-01013-000-t2f.nii.gz,../../DataSet/ASNR-MICCAI-BraTS2023-GLI-Challenge-TrainingData/BraTS-GLI-01013-000/BraTS-GLI-01013-000-t1n.nii.gz,../../DataSet/ASNR-MICCAI-BraTS2023-GLI-Challenge-TrainingData/BraTS-GLI-01013-000/BraTS-GLI-01013-000-seg.nii.gz,138,187,79,118,166,157,215,48,114,48,58,66
01472-000,../../DataSet/ASNR-MICCAI-BraTS2023-GLI-Challenge-TrainingData/BraTS-GLI-01472-000/BraTS-GLI-01472-000-t1c.nii.gz,../../DataSet/ASNR-MICCAI-BraTS2023-GLI-Challenge-TrainingData/BraTS-GLI-01472-000/BraTS-GLI-01472-000-t2w.nii.gz,../../DataSet/ASNR-MICCAI-BraTS2023-GLI-Challenge-TrainingData/BraTS-GLI-01472-000/BraTS-GLI-01472-000-t2f.nii.gz,../../DataSet/ASNR-MICCAI-BraTS2023-GLI-Challenge-TrainingData/BraTS-GLI-01472-000/BraTS-GLI-01472-000-t1n.nii.gz,../../DataSet/ASNR-MICCAI-BraTS2023-GLI-Challenge-TrainingData/BraTS-GLI-01472-000/BraTS-GLI-01472-000-seg.nii.gz,154,116,47,130,180,85,161,24,73,50,76,49
00777-000,../../DataSet/ASNR-MICCAI-BraTS2023-GLI-Challenge-TrainingData/BraTS-GLI-00777-000/BraTS-GLI-00777-000-t1c.nii.gz,../../DataSet/ASNR-MICCAI-BraTS2023-GLI-Challenge-TrainingData/BraTS-GLI-00777-000/BraTS-GLI-00777-000-t2w.nii.gz,../../DataSet/ASNR-MICCAI-BraTS2023-GLI-Challenge-TrainingData/BraTS-GLI-00777-000/BraTS-GLI-00777-000-t2f.nii.gz,../../DataSet/ASNR-MICCAI-BraTS2023-GLI-Challenge-TrainingData/BraTS-GLI-00777-000/BraTS-GLI-00777-000-t1n.nii.gz,../../DataSet/ASNR-MICCAI-BraTS2023-GLI-Challenge-TrainingData/BraTS-GLI-00777-000/BraTS-GLI-00777-000-seg.nii.gz,83,127,95,56,113,83,168,66,131,57,85,65
01137-000,../../DataSet/ASNR-MICCAI-BraTS2023-GLI-Challenge-TrainingData/BraTS-GLI-01137-000/BraTS-GLI-01137-000-t1c.nii.gz,../../DataSet/ASNR-MICCAI-BraTS2023-GLI-Challenge-TrainingData/BraTS-GLI-01137-000/BraTS-GLI-01137-000-t2w.nii.gz,../../DataSet/ASNR-MICCAI-BraTS2023-GLI-Challenge-TrainingData/BraTS-GLI-01137-000/BraTS-GLI-01137-000-t2f.nii.gz,../../DataSet/ASNR-MICCAI-BraTS2023-GLI-Challenge-TrainingData/BraTS-GLI-01137-000/BraTS-GLI-01137-000-t1n.nii.gz,../../DataSet/ASNR-MICCAI-BraTS2023-GLI-Challenge-TrainingData/BraTS-GLI-01137-000/BraTS-GLI-01137-000-seg.nii.gz,113,162,36,91,136,137,189,15,64,45,52,49
00316-000,../../DataSet/ASNR-MICCAI-BraTS2023-GLI-Challenge-TrainingData/BraTS-GLI-00316-000/BraTS-GLI-00316-000-t1c.nii.gz,../../DataSet/ASNR-MICCAI-BraTS2023-GLI-Challenge-TrainingData/BraTS-GLI-00316-000/BraTS-GLI-00316-000-t2w.nii.gz,../../DataSet/ASNR-MICCAI-BraTS2023-GLI-Challenge-TrainingData/BraTS-GLI-00316-000/BraTS-GLI-00316-000-t2f.nii.gz,../../DataSet/ASNR-MICCAI-BraTS2023-GLI-Challenge-TrainingData/BraTS-GLI-00316-000/BraTS-GLI-00316-000-t1n.nii.gz,../../DataSet/ASNR-MICCAI-BraTS2023-GLI-Challenge-TrainingData/BraTS-GLI-00316-000/BraTS-GLI-00316-000-seg.nii.gz,105,113,98,84,133,89,138,72,134,49,49,62
01220-000,../../DataSet/ASNR-MICCAI-BraTS2023-GLI-Challenge-TrainingData/BraTS-GLI-01220-000/BraTS-GLI-01220-000-t1c.nii.gz,../../DataSet/ASNR-MICCAI-BraTS2023-GLI-Challenge-TrainingData/BraTS-GLI-01220-000/BraTS-GLI-01220-000-t2w.nii.gz,../../DataSet/ASNR-MICCAI-BraTS2023-GLI-Challenge-TrainingData/BraTS-GLI-01220-000/BraTS-GLI-01220-000-t2f.nii.gz,../../DataSet/ASNR-MICCAI-BraTS2023-GLI-Challenge-TrainingData/BraTS-GLI-01220-000/BraTS-GLI-01220-000-t1n.nii.gz,../../DataSet/ASNR-MICCAI-BraTS2023-GLI-Challenge-TrainingData/BraTS-GLI-01220-000/BraTS-GLI-01220-000-seg.nii.gz,101,144,78,73,123,95,176,60,104,50,81,44
01378-000,../../DataSet/ASNR-MICCAI-BraTS2023-GLI-Challenge-TrainingData/BraTS-GLI-01378-000/BraTS-GLI-01378-000-t1c.nii.gz,../../DataSet/ASNR-MICCAI-BraTS2023-GLI-Challenge-TrainingData/BraTS-GLI-01378-000/BraTS-GLI-01378-000-t2w.nii.gz,../../DataSet/ASNR-MICCAI-BraTS2023-GLI-Challenge-TrainingData/BraTS-GLI-01378-000/BraTS-GLI-01378-000-t2f.nii.gz,../../DataSet/ASNR-MICCAI-BraTS2023-GLI-Challenge-TrainingData/BraTS-GLI-01378-000/BraTS-GLI-01378-000-t1n.nii.gz,../../DataSet/ASNR-MICCAI-BraTS2023-GLI-Challenge-TrainingData/BraTS-GLI-01378-000/BraTS-GLI-01378-000-seg.nii.gz,153,139,73,121,186,93,186,38,115,65,93,77
00188-000,../../DataSet/ASNR-MICCAI-BraTS2023-GLI-Challenge-TrainingData/BraTS-GLI-00188-000/BraTS-GLI-00188-000-t1c.nii.gz,../../DataSet/ASNR-MICCAI-BraTS2023-GLI-Challenge-TrainingData/BraTS-GLI-00188-000/BraTS-GLI-00188-000-t2w.nii.gz,../../DataSet/ASNR-MICCAI-BraTS2023-GLI-Challenge-TrainingData/BraTS-GLI-00188-000/BraTS-GLI-00188-000-t2f.nii.gz,../../DataSet/ASNR-MICCAI-BraTS2023-GLI-Challenge-TrainingData/BraTS-GLI-00188-000/BraTS-GLI-00188-000-t1n.nii.gz,../../DataSet/ASNR-MICCAI-BraTS2023-GLI-Challenge-TrainingData/BraTS-GLI-00188-000/BraTS-GLI-00188-000-seg.nii.gz,139,143,99,120,162,117,175,68,133,42,58,65
01130-000,../../DataSet/ASNR-MICCAI-BraTS2023-GLI-Challenge-TrainingData/BraTS-GLI-01130-000/BraTS-GLI-01130-000-t1c.nii.gz,../../DataSet/ASNR-MICCAI-BraTS2023-GLI-Challenge-TrainingData/BraTS-GLI-01130-000/BraTS-GLI-01130-000-t2w.nii.gz,../../DataSet/ASNR-MICCAI-BraTS2023-GLI-Challenge-TrainingData/BraTS-GLI-01130-000/BraTS-GLI-01130-000-t2f.nii.gz,../../DataSet/ASNR-MICCAI-BraTS2023-GLI-Challenge-TrainingData/BraTS-GLI-01130-000/BraTS-GLI-01130-000-t1n.nii.gz,../../DataSet/ASNR-MICCAI-BraTS2023-GLI-Challenge-TrainingData/BraTS-GLI-01130-000/BraTS-GLI-01130-000-seg.nii.gz,108,104,76,73,134,72,136,52,112,61,64,60
00311-000,../../DataSet/ASNR-MICCAI-BraTS2023-GLI-Challenge-TrainingData/BraTS-GLI-00311-000/BraTS-GLI-00311-000-t1c.nii.gz,../../DataSet/ASNR-MICCAI-BraTS2023-GLI-Challenge-TrainingData/BraTS-GLI-00311-000/BraTS-GLI-00311-000-t2w.nii.gz,../../DataSet/ASNR-MICCAI-BraTS2023-GLI-Challenge-TrainingData/BraTS-GLI-00311-000/BraTS-GLI-00311-000-t2f.nii.gz,../../DataSet/ASNR-MICCAI-BraTS2023-GLI-Challenge-TrainingData/BraTS-GLI-00311-000/BraTS-GLI-00311-000-t1n.nii.gz,../../DataSet/ASNR-MICCAI-BraTS2023-GLI-Challenge-TrainingData/BraTS-GLI-00311-000/BraTS-GLI-00311-000-seg.nii.gz,167,129,89,149,186,109,150,72,112,37,41,40
01227-000,../../DataSet/ASNR-MICCAI-BraTS2023-GLI-Challenge-TrainingData/BraTS-GLI-01227-000/BraTS-GLI-01227-000-t1c.nii.gz,../../DataSet/ASNR-MICCAI-BraTS2023-GLI-Challenge-TrainingData/BraTS-GLI-01227-000/BraTS-GLI-01227-000-t2w.nii.gz,../../DataSet/ASNR-MICCAI-BraTS2023-GLI-Challenge-TrainingData/BraTS-GLI-01227-000/BraTS-GLI-01227-000-t2f.nii.gz,../../DataSet/ASNR-MICCAI-BraTS2023-GLI-Challenge-TrainingData/BraTS-GLI-01227-000/BraTS-GLI-01227-000-t1n.nii.gz,../../DataSet/ASNR-MICCAI-BraTS2023-GLI-Challenge-TrainingData/BraTS-GLI-01227-000/BraTS-GLI-01227-000-seg.nii.gz,140,127,105,77,168,91,162,75,135,91,71,60
00006-000,../../DataSet/ASNR-MICCAI-BraTS2023-GLI-Challenge-TrainingData/BraTS-GLI-00006-000/BraTS-GLI-00006-000-t1c.nii.gz,../../DataSet/ASNR-MICCAI-BraTS2023-GLI-Challenge-TrainingData/BraTS-GLI-00006-000/BraTS-GLI-00006-000-t2w.nii.gz,../../DataSet/ASNR-MICCAI-BraTS2023-GLI-Challenge-TrainingData/BraTS-GLI-00006-000/BraTS-GLI-00006-000-t2f.nii.gz,../../DataSet/ASNR-MICCAI-BraTS2023-GLI-Challenge-TrainingData/BraTS-GLI-00006-000/BraTS-GLI-00006-000-t1n.nii.gz,../../DataSet/ASNR-MICCAI-BraTS2023-GLI-Challenge-TrainingData/BraTS-GLI-00006-000/BraTS-GLI-00006-000-seg.nii.gz,129,75,74,92,166,39,109,45,112,74,70,67
00298-000,../../DataSet/ASNR-MICCAI-BraTS2023-GLI-Challenge-TrainingData/BraTS-GLI-00298-000/BraTS-GLI-00298-000-t1c.nii.gz,../../DataSet/ASNR-MICCAI-BraTS2023-GLI-Challenge-TrainingData/BraTS-GLI-00298-000/BraTS-GLI-00298-000-t2w.nii.gz,../../DataSet/ASNR-MICCAI-BraTS2023-GLI-Challenge-TrainingData/BraTS-GLI-00298-000/BraTS-GLI-00298-000-t2f.nii.gz,../../DataSet/ASNR-MICCAI-BraTS2023-GLI-Challenge-TrainingData/BraTS-GLI-00298-000/BraTS-GLI-00298-000-t1n.nii.gz,../../DataSet/ASNR-MICCAI-BraTS2023-GLI-Challenge-TrainingData/BraTS-GLI-00298-000/BraTS-GLI-00298-000-seg.nii.gz,83,159,77,62,103,132,184,52,102,41,52,50
01068-000,../../DataSet/ASNR-MICCAI-BraTS2023-GLI-Challenge-TrainingData/BraTS-GLI-01068-000/BraTS-GLI-01068-000-t1c.nii.gz,../../DataSet/ASNR-MICCAI-BraTS2023-GLI-Challenge-TrainingData/BraTS-GLI-01068-000/BraTS-GLI-01068-000-t2w.nii.gz,../../DataSet/ASNR-MICCAI-BraTS2023-GLI-Challenge-TrainingData/BraTS-GLI-01068-000/BraTS-GLI-01068-000-t2f.nii.gz,../../DataSet/ASNR-MICCAI-BraTS2023-GLI-Challenge-TrainingData/BraTS-GLI-01068-000/BraTS-GLI-01068-000-t1n.nii.gz,../../DataSet/ASNR-MICCAI-BraTS2023-GLI-Challenge-TrainingData/BraTS-GLI-01068-000/BraTS-GLI-01068-000-seg.nii.gz,162,113,58,141,185,83,167,40,84,44,84,44
00628-000,../../DataSet/ASNR-MICCAI-BraTS2023-GLI-Challenge-TrainingData/BraTS-GLI-00628-000/BraTS-GLI-00628-000-t1c.nii.gz,../../DataSet/ASNR-MICCAI-BraTS2023-GLI-Challenge-TrainingData/BraTS-GLI-00628-000/BraTS-GLI-00628-000-t2w.nii.gz,../../DataSet/ASNR-MICCAI-BraTS2023-GLI-Challenge-TrainingData/BraTS-GLI-00628-000/BraTS-GLI-00628-000-t2f.nii.gz,../../DataSet/ASNR-MICCAI-BraTS2023-GLI-Challenge-TrainingData/BraTS-GLI-00628-000/BraTS-GLI-00628-000-t1n.nii.gz,../../DataSet/ASNR-MICCAI-BraTS2023-GLI-Challenge-TrainingData/BraTS-GLI-00628-000/BraTS-GLI-00628-000-seg.nii.gz,86,88,91,64,111,55,128,64,128,47,73,64
00249-000,../../DataSet/ASNR-MICCAI-BraTS2023-GLI-Challenge-TrainingData/BraTS-GLI-00249-000/BraTS-GLI-00249-000-t1c.nii.gz,../../DataSet/ASNR-MICCAI-BraTS2023-GLI-Challenge-TrainingData/BraTS-GLI-00249-000/BraTS-GLI-00249-000-t2w.nii.gz,../../DataSet/ASNR-MICCAI-BraTS2023-GLI-Challenge-TrainingData/BraTS-GLI-00249-000/BraTS-GLI-00249-000-t2f.nii.gz,../../DataSet/ASNR-MICCAI-BraTS2023-GLI-Challenge-TrainingData/BraTS-GLI-00249-000/BraTS-GLI-00249-000-t1n.nii.gz,../../DataSet/ASNR-MICCAI-BraTS2023-GLI-Challenge-TrainingData/BraTS-GLI-00249-000/BraTS-GLI-00249-000-seg.nii.gz,154,126,65,126,181,86,172,32,96,55,86,64
01409-000,../../DataSet/ASNR-MICCAI-BraTS2023-GLI-Challenge-TrainingData/BraTS-GLI-01409-000/BraTS-GLI-01409-000-t1c.nii.gz,../../DataSet/ASNR-MICCAI-BraTS2023-GLI-Challenge-TrainingData/BraTS-GLI-01409-000/BraTS-GLI-01409-000-t2w.nii.gz,../../DataSet/ASNR-MICCAI-BraTS2023-GLI-Challenge-TrainingData/BraTS-GLI-01409-000/BraTS-GLI-01409-000-t2f.nii.gz,../../DataSet/ASNR-MICCAI-BraTS2023-GLI-Challenge-TrainingData/BraTS-GLI-01409-000/BraTS-GLI-01409-000-t1n.nii.gz,../../DataSet/ASNR-MICCAI-BraTS2023-GLI-Challenge-TrainingData/BraTS-GLI-01409-000/BraTS-GLI-01409-000-seg.nii.gz,95,145,81,75,118,109,188,52,131,43,79,79
01303-000,../../DataSet/ASNR-MICCAI-BraTS2023-GLI-Challenge-TrainingData/BraTS-GLI-01303-000/BraTS-GLI-01303-000-t1c.nii.gz,../../DataSet/ASNR-MICCAI-BraTS2023-GLI-Challenge-TrainingData/BraTS-GLI-01303-000/BraTS-GLI-01303-000-t2w.nii.gz,../../DataSet/ASNR-MICCAI-BraTS2023-GLI-Challenge-TrainingData/BraTS-GLI-01303-000/BraTS-GLI-01303-000-t2f.nii.gz,../../DataSet/ASNR-MICCAI-BraTS2023-GLI-Challenge-TrainingData/BraTS-GLI-01303-000/BraTS-GLI-01303-000-t1n.nii.gz,../../DataSet/ASNR-MICCAI-BraTS2023-GLI-Challenge-TrainingData/BraTS-GLI-01303-000/BraTS-GLI-01303-000-seg.nii.gz,141,162,94,119,169,127,198,53,135,50,71,82
00122-000,../../DataSet/ASNR-MICCAI-BraTS2023-GLI-Challenge-TrainingData/BraTS-GLI-00122-000/BraTS-GLI-00122-000-t1c.nii.gz,../../DataSet/ASNR-MICCAI-BraTS2023-GLI-Challenge-TrainingData/BraTS-GLI-00122-000/BraTS-GLI-00122-000-t2w.nii.gz,../../DataSet/ASNR-MICCAI-BraTS2023-GLI-Challenge-TrainingData/BraTS-GLI-00122-000/BraTS-GLI-00122-000-t2f.nii.gz,../../DataSet/ASNR-MICCAI-BraTS2023-GLI-Challenge-TrainingData/BraTS-GLI-00122-000/BraTS-GLI-00122-000-t1n.nii.gz,../../DataSet/ASNR-MICCAI-BraTS2023-GLI-Challenge-TrainingData/BraTS-GLI-00122-000/BraTS-GLI-00122-000-seg.nii.gz,155,154,62,134,178,126,186,42,92,44,60,50
01014-000,../../DataSet/ASNR-MICCAI-BraTS2023-GLI-Challenge-TrainingData/BraTS-GLI-01014-000/BraTS-GLI-01014-000-t1c.nii.gz,../../DataSet/ASNR-MICCAI-BraTS2023-GLI-Challenge-TrainingData/BraTS-GLI-01014-000/BraTS-GLI-01014-000-t2w.nii.gz,../../DataSet/ASNR-MICCAI-BraTS2023-GLI-Challenge-TrainingData/BraTS-GLI-01014-000/BraTS-GLI-01014-000-t2f.nii.gz,../../DataSet/ASNR-MICCAI-BraTS2023-GLI-Challenge-TrainingData/BraTS-GLI-01014-000/BraTS-GLI-01014-000-t1n.nii.gz,../../DataSet/ASNR-MICCAI-BraTS2023-GLI-Challenge-TrainingData/BraTS-GLI-01014-000/BraTS-GLI-01014-000-seg.nii.gz,159,153,72,137,183,134,174,49,96,46,40,47
00654-000,../../DataSet/ASNR-MICCAI-BraTS2023-GLI-Challenge-TrainingData/BraTS-GLI-00654-000/BraTS-GLI-00654-000-t1c.nii.gz,../../DataSet/ASNR-MICCAI-BraTS2023-GLI-Challenge-TrainingData/BraTS-GLI-00654-000/BraTS-GLI-00654-000-t2w.nii.gz,../../DataSet/ASNR-MICCAI-BraTS2023-GLI-Challenge-TrainingData/BraTS-GLI-00654-000/BraTS-GLI-00654-000-t2f.nii.gz,../../DataSet/ASNR-MICCAI-BraTS2023-GLI-Challenge-TrainingData/BraTS-GLI-00654-000/BraTS-GLI-00654-000-t1n.nii.gz,../../DataSet/ASNR-MICCAI-BraTS2023-GLI-Challenge-TrainingData/BraTS-GLI-00654-000/BraTS-GLI-00654-000-seg.nii.gz,90,103,90,58,143,52,141,36,129,85,89,93
00235-000,../../DataSet/ASNR-MICCAI-BraTS2023-GLI-Challenge-TrainingData/BraTS-GLI-00235-000/BraTS-GLI-00235-000-t1c.nii.gz,../../DataSet/ASNR-MICCAI-BraTS2023-GLI-Challenge-TrainingData/BraTS-GLI-00235-000/BraTS-GLI-00235-000-t2w.nii.gz,../../DataSet/ASNR-MICCAI-BraTS2023-GLI-Challenge-TrainingData/BraTS-GLI-00235-000/BraTS-GLI-00235-000-t2f.nii.gz,../../DataSet/ASNR-MICCAI-BraTS2023-GLI-Challenge-TrainingData/BraTS-GLI-00235-000/BraTS-GLI-00235-000-t1n.nii.gz,../../DataSet/ASNR-MICCAI-BraTS2023-GLI-Challenge-TrainingData/BraTS-GLI-00235-000/BraTS-GLI-00235-000-seg.nii.gz,95,163,90,66,122,130,203,54,137,56,73,83
01475-000,../../DataSet/ASNR-MICCAI-BraTS2023-GLI-Challenge-TrainingData/BraTS-GLI-01475-000/BraTS-GLI-01475-000-t1c.nii.gz,../../DataSet/ASNR-MICCAI-BraTS2023-GLI-Challenge-TrainingData/BraTS-GLI-01475-000/BraTS-GLI-01475-000-t2w.nii.gz,../../DataSet/ASNR-MICCAI-BraTS2023-GLI-Challenge-TrainingData/BraTS-GLI-01475-000/BraTS-GLI-01475-000-t2f.nii.gz,../../DataSet/ASNR-MICCAI-BraTS2023-GLI-Challenge-TrainingData/BraTS-GLI-01475-000/BraTS-GLI-01475-000-t1n.nii.gz,../../DataSet/ASNR-MICCAI-BraTS2023-GLI-Challenge-TrainingData/BraTS-GLI-01475-000/BraTS-GLI-01475-000-seg.nii.gz,141,89,83,102,177,40,131,42,121,75,91,79
00469-000,../../DataSet/ASNR-MICCAI-BraTS2023-GLI-Challenge-TrainingData/BraTS-GLI-00469-000/BraTS-GLI-00469-000-t1c.nii.gz,../../DataSet/ASNR-MICCAI-BraTS2023-GLI-Challenge-TrainingData/BraTS-GLI-00469-000/BraTS-GLI-00469-000-t2w.nii.gz,../../DataSet/ASNR-MICCAI-BraTS2023-GLI-Challenge-TrainingData/BraTS-GLI-00469-000/BraTS-GLI-00469-000-t2f.nii.gz,../../DataSet/ASNR-MICCAI-BraTS2023-GLI-Challenge-TrainingData/BraTS-GLI-00469-000/BraTS-GLI-00469-000-t1n.nii.gz,../../DataSet/ASNR-MICCAI-BraTS2023-GLI-Challenge-TrainingData/BraTS-GLI-00469-000/BraTS-GLI-00469-000-seg.nii.gz,152,137,83,121,184,100,175,58,109,63,75,51
01229-000,../../DataSet/ASNR-MICCAI-BraTS2023-GLI-Challenge-TrainingData/BraTS-GLI-01229-000/BraTS-GLI-01229-000-t1c.nii.gz,../../DataSet/ASNR-MICCAI-BraTS2023-GLI-Challenge-TrainingData/BraTS-GLI-01229-000/BraTS-GLI-01229-000-t2w.nii.gz,../../DataSet/ASNR-MICCAI-BraTS2023-GLI-Challenge-TrainingData/BraTS-GLI-01229-000/BraTS-GLI-01229-000-t2f.nii.gz,../../DataSet/ASNR-MICCAI-BraTS2023-GLI-Challenge-TrainingData/BraTS-GLI-01229-000/BraTS-GLI-01229-000-t1n.nii.gz,../../DataSet/ASNR-MICCAI-BraTS2023-GLI-Challenge-TrainingData/BraTS-GLI-01229-000/BraTS-GLI-01229-000-seg.nii.gz,154,119,69,116,184,82,164,29,104,68,82,75
00008-000,../../DataSet/ASNR-MICCAI-BraTS2023-GLI-Challenge-TrainingData/BraTS-GLI-00008-000/BraTS-GLI-00008-000-t1c.nii.gz,../../DataSet/ASNR-MICCAI-BraTS2023-GLI-Challenge-TrainingData/BraTS-GLI-00008-000/BraTS-GLI-00008-000-t2w.nii.gz,../../DataSet/ASNR-MICCAI-BraTS2023-GLI-Challenge-TrainingData/BraTS-GLI-00008-000/BraTS-GLI-00008-000-t2f.nii.gz,../../DataSet/ASNR-MICCAI-BraTS2023-GLI-Challenge-TrainingData/BraTS-GLI-00008-000/BraTS-GLI-00008-000-t1n.nii.gz,../../DataSet/ASNR-MICCAI-BraTS2023-GLI-Challenge-TrainingData/BraTS-GLI-00008-000/BraTS-GLI-00008-000-seg.nii.gz,75,153,70,56,92,138,171,52,91,36,33,39
00296-000,../../DataSet/ASNR-MICCAI-BraTS2023-GLI-Challenge-TrainingData/BraTS-GLI-00296-000/BraTS-GLI-00296-000-t1c.nii.gz,../../DataSet/ASNR-MICCAI-BraTS2023-GLI-Challenge-TrainingData/BraTS-GLI-00296-000/BraTS-GLI-00296-000-t2w.nii.gz,../../DataSet/ASNR-MICCAI-BraTS2023-GLI-Challenge-TrainingData/BraTS-GLI-00296-000/BraTS-GLI-00296-000-t2f.nii.gz,../../DataSet/ASNR-MICCAI-BraTS2023-GLI-Challenge-TrainingData/BraTS-GLI-00296-000/BraTS-GLI-00296-000-t1n.nii.gz,../../DataSet/ASNR-MICCAI-BraTS2023-GLI-Challenge-TrainingData/BraTS-GLI-00296-000/BraTS-GLI-00296-000-seg.nii.gz,133,107,102,111,177,77,141,84,129,66,64,45
00775-001,../../DataSet/ASNR-MICCAI-BraTS2023-GLI-Challenge-TrainingData/BraTS-GLI-00775-001/BraTS-GLI-00775-001-t1c.nii.gz,../../DataSet/ASNR-MICCAI-BraTS2023-GLI-Challenge-TrainingData/BraTS-GLI-00775-001/BraTS-GLI-00775-001-t2w.nii.gz,../../DataSet/ASNR-MICCAI-BraTS2023-GLI-Challenge-TrainingData/BraTS-GLI-00775-001/BraTS-GLI-00775-001-t2f.nii.gz,../../DataSet/ASNR-MICCAI-BraTS2023-GLI-Challenge-TrainingData/BraTS-GLI-00775-001/BraTS-GLI-00775-001-t1n.nii.gz,../../DataSet/ASNR-MICCAI-BraTS2023-GLI-Challenge-TrainingData/BraTS-GLI-00775-001/BraTS-GLI-00775-001-seg.nii.gz,90,120,52,71,147,86,162,31,79,76,76,48
00150-000,../../DataSet/ASNR-MICCAI-BraTS2023-GLI-Challenge-TrainingData/BraTS-GLI-00150-000/BraTS-GLI-00150-000-t1c.nii.gz,../../DataSet/ASNR-MICCAI-BraTS2023-GLI-Challenge-TrainingData/BraTS-GLI-00150-000/BraTS-GLI-00150-000-t2w.nii.gz,../../DataSet/ASNR-MICCAI-BraTS2023-GLI-Challenge-TrainingData/BraTS-GLI-00150-000/BraTS-GLI-00150-000-t2f.nii.gz,../../DataSet/ASNR-MICCAI-BraTS2023-GLI-Challenge-TrainingData/BraTS-GLI-00150-000/BraTS-GLI-00150-000-t1n.nii.gz,../../DataSet/ASNR-MICCAI-BraTS2023-GLI-Challenge-TrainingData/BraTS-GLI-00150-000/BraTS-GLI-00150-000-seg.nii.gz,90,116,71,56,134,73,162,31,106,78,89,75
00626-000,../../DataSet/ASNR-MICCAI-BraTS2023-GLI-Challenge-TrainingData/BraTS-GLI-00626-000/BraTS-GLI-00626-000-t1c.nii.gz,../../DataSet/ASNR-MICCAI-BraTS2023-GLI-Challenge-TrainingData/BraTS-GLI-00626-000/BraTS-GLI-00626-000-t2w.nii.gz,../../DataSet/ASNR-MICCAI-BraTS2023-GLI-Challenge-TrainingData/BraTS-GLI-00626-000/BraTS-GLI-00626-000-t2f.nii.gz,../../DataSet/ASNR-MICCAI-BraTS2023-GLI-Challenge-TrainingData/BraTS-GLI-00626-000/BraTS-GLI-00626-000-t1n.nii.gz,../../DataSet/ASNR-MICCAI-BraTS2023-GLI-Challenge-TrainingData/BraTS-GLI-00626-000/BraTS-GLI-00626-000-seg.nii.gz,149,138,59,134,169,113,171,41,78,35,58,37
01407-000,../../DataSet/ASNR-MICCAI-BraTS2023-GLI-Challenge-TrainingData/BraTS-GLI-01407-000/BraTS-GLI-01407-000-t1c.nii.gz,../../DataSet/ASNR-MICCAI-BraTS2023-GLI-Challenge-TrainingData/BraTS-GLI-01407-000/BraTS-GLI-01407-000-t2w.nii.gz,../../DataSet/ASNR-MICCAI-BraTS2023-GLI-Challenge-TrainingData/BraTS-GLI-01407-000/BraTS-GLI-01407-000-t2f.nii.gz,../../DataSet/ASNR-MICCAI-BraTS2023-GLI-Challenge-TrainingData/BraTS-GLI-01407-000/BraTS-GLI-01407-000-t1n.nii.gz,../../DataSet/ASNR-MICCAI-BraTS2023-GLI-Challenge-TrainingData/BraTS-GLI-01407-000/BraTS-GLI-01407-000-seg.nii.gz,145,134,54,132,159,117,154,42,68,27,37,26
00680-001,../../DataSet/ASNR-MICCAI-BraTS2023-GLI-Challenge-TrainingData/BraTS-GLI-00680-001/BraTS-GLI-00680-001-t1c.nii.gz,../../DataSet/ASNR-MICCAI-BraTS2023-GLI-Challenge-TrainingData/BraTS-GLI-00680-001/BraTS-GLI-00680-001-t2w.nii.gz,../../DataSet/ASNR-MICCAI-BraTS2023-GLI-Challenge-TrainingData/BraTS-GLI-00680-001/BraTS-GLI-00680-001-t2f.nii.gz,../../DataSet/ASNR-MICCAI-BraTS2023-GLI-Challenge-TrainingData/BraTS-GLI-00680-001/BraTS-GLI-00680-001-t1n.nii.gz,../../DataSet/ASNR-MICCAI-BraTS2023-GLI-Challenge-TrainingData/BraTS-GLI-00680-001/BraTS-GLI-00680-001-seg.nii.gz,151,107,80,132,178,71,148,52,109,46,77,57
01142-000,../../DataSet/ASNR-MICCAI-BraTS2023-GLI-Challenge-TrainingData/BraTS-GLI-01142-000/BraTS-GLI-01142-000-t1c.nii.gz,../../DataSet/ASNR-MICCAI-BraTS2023-GLI-Challenge-TrainingData/BraTS-GLI-01142-000/BraTS-GLI-01142-000-t2w.nii.gz,../../DataSet/ASNR-MICCAI-BraTS2023-GLI-Challenge-TrainingData/BraTS-GLI-01142-000/BraTS-GLI-01142-000-t2f.nii.gz,../../DataSet/ASNR-MICCAI-BraTS2023-GLI-Challenge-TrainingData/BraTS-GLI-01142-000/BraTS-GLI-01142-000-t1n.nii.gz,../../DataSet/ASNR-MICCAI-BraTS2023-GLI-Challenge-TrainingData/BraTS-GLI-01142-000/BraTS-GLI-01142-000-seg.nii.gz,158,149,68,127,189,98,194,30,114,62,96,84
01523-000,../../DataSet/ASNR-MICCAI-BraTS2023-GLI-Challenge-TrainingData/BraTS-GLI-01523-000/BraTS-GLI-01523-000-t1c.nii.gz,../../DataSet/ASNR-MICCAI-BraTS2023-GLI-Challenge-TrainingData/BraTS-GLI-01523-000/BraTS-GLI-01523-000-t2w.nii.gz,../../DataSet/ASNR-MICCAI-BraTS2023-GLI-Challenge-TrainingData/BraTS-GLI-01523-000/BraTS-GLI-01523-000-t2f.nii.gz,../../DataSet/ASNR-MICCAI-BraTS2023-GLI-Challenge-TrainingData/BraTS-GLI-01523-000/BraTS-GLI-01523-000-t1n.nii.gz,../../DataSet/ASNR-MICCAI-BraTS2023-GLI-Challenge-TrainingData/BraTS-GLI-01523-000/BraTS-GLI-01523-000-seg.nii.gz,93,103,83,58,147,57,151,40,121,89,94,81
01255-000,../../DataSet/ASNR-MICCAI-BraTS2023-GLI-Challenge-TrainingData/BraTS-GLI-01255-000/BraTS-GLI-01255-000-t1c.nii.gz,../../DataSet/ASNR-MICCAI-BraTS2023-GLI-Challenge-TrainingData/BraTS-GLI-01255-000/BraTS-GLI-01255-000-t2w.nii.gz,../../DataSet/ASNR-MICCAI-BraTS2023-GLI-Challenge-TrainingData/BraTS-GLI-01255-000/BraTS-GLI-01255-000-t2f.nii.gz,../../DataSet/ASNR-MICCAI-BraTS2023-GLI-Challenge-TrainingData/BraTS-GLI-01255-000/BraTS-GLI-01255-000-t1n.nii.gz,../../DataSet/ASNR-MICCAI-BraTS2023-GLI-Challenge-TrainingData/BraTS-GLI-01255-000/BraTS-GLI-01255-000-seg.nii.gz,149,143,52,131,166,114,178,45,67,35,64,22
01193-000,../../DataSet/ASNR-MICCAI-BraTS2023-GLI-Challenge-TrainingData/BraTS-GLI-01193-000/BraTS-GLI-01193-000-t1c.nii.gz,../../DataSet/ASNR-MICCAI-BraTS2023-GLI-Challenge-TrainingData/BraTS-GLI-01193-000/BraTS-GLI-01193-000-t2w.nii.gz,../../DataSet/ASNR-MICCAI-BraTS2023-GLI-Challenge-TrainingData/BraTS-GLI-01193-000/BraTS-GLI-01193-000-t2f.nii.gz,../../DataSet/ASNR-MICCAI-BraTS2023-GLI-Challenge-TrainingData/BraTS-GLI-01193-000/BraTS-GLI-01193-000-t1n.nii.gz,../../DataSet/ASNR-MICCAI-BraTS2023-GLI-Challenge-TrainingData/BraTS-GLI-01193-000/BraTS-GLI-01193-000-seg.nii.gz,156,142,62,132,181,95,189,39,89,49,94,50
01145-000,../../DataSet/ASNR-MICCAI-BraTS2023-GLI-Challenge-TrainingData/BraTS-GLI-01145-000/BraTS-GLI-01145-000-t1c.nii.gz,../../DataSet/ASNR-MICCAI-BraTS2023-GLI-Challenge-TrainingData/BraTS-GLI-01145-000/BraTS-GLI-01145-000-t2w.nii.gz,../../DataSet/ASNR-MICCAI-BraTS2023-GLI-Challenge-TrainingData/BraTS-GLI-01145-000/BraTS-GLI-01145-000-t2f.nii.gz,../../DataSet/ASNR-MICCAI-BraTS2023-GLI-Challenge-TrainingData/BraTS-GLI-01145-000/BraTS-GLI-01145-000-t1n.nii.gz,../../DataSet/ASNR-MICCAI-BraTS2023-GLI-Challenge-TrainingData/BraTS-GLI-01145-000/BraTS-GLI-01145-000-seg.nii.gz,103,82,83,68,141,48,120,56,118,73,72,62
00705-000,../../DataSet/ASNR-MICCAI-BraTS2023-GLI-Challenge-TrainingData/BraTS-GLI-00705-000/BraTS-GLI-00705-000-t1c.nii.gz,../../DataSet/ASNR-MICCAI-BraTS2023-GLI-Challenge-TrainingData/BraTS-GLI-00705-000/BraTS-GLI-00705-000-t2w.nii.gz,../../DataSet/ASNR-MICCAI-BraTS2023-GLI-Challenge-TrainingData/BraTS-GLI-00705-000/BraTS-GLI-00705-000-t2f.nii.gz,../../DataSet/ASNR-MICCAI-BraTS2023-GLI-Challenge-TrainingData/BraTS-GLI-00705-000/BraTS-GLI-00705-000-t1n.nii.gz,../../DataSet/ASNR-MICCAI-BraTS2023-GLI-Challenge-TrainingData/BraTS-GLI-00705-000/BraTS-GLI-00705-000-seg.nii.gz,139,104,126,123,157,75,128,112,142,34,53,30
00364-000,../../DataSet/ASNR-MICCAI-BraTS2023-GLI-Challenge-TrainingData/BraTS-GLI-00364-000/BraTS-GLI-00364-000-t1c.nii.gz,../../DataSet/ASNR-MICCAI-BraTS2023-GLI-Challenge-TrainingData/BraTS-GLI-00364-000/BraTS-GLI-00364-000-t2w.nii.gz,../../DataSet/ASNR-MICCAI-BraTS2023-GLI-Challenge-TrainingData/BraTS-GLI-00364-000/BraTS-GLI-00364-000-t2f.nii.gz,../../DataSet/ASNR-MICCAI-BraTS2023-GLI-Challenge-TrainingData/BraTS-GLI-00364-000/BraTS-GLI-00364-000-t1n.nii.gz,../../DataSet/ASNR-MICCAI-BraTS2023-GLI-Challenge-TrainingData/BraTS-GLI-00364-000/BraTS-GLI-00364-000-seg.nii.gz,137,114,96,102,167,88,143,71,125,65,55,54
01524-000,../../DataSet/ASNR-MICCAI-BraTS2023-GLI-Challenge-TrainingData/BraTS-GLI-01524-000/BraTS-GLI-01524-000-t1c.nii.gz,../../DataSet/ASNR-MICCAI-BraTS2023-GLI-Challenge-TrainingData/BraTS-GLI-01524-000/BraTS-GLI-01524-000-t2w.nii.gz,../../DataSet/ASNR-MICCAI-BraTS2023-GLI-Challenge-TrainingData/BraTS-GLI-01524-000/BraTS-GLI-01524-000-t2f.nii.gz,../../DataSet/ASNR-MICCAI-BraTS2023-GLI-Challenge-TrainingData/BraTS-GLI-01524-000/BraTS-GLI-01524-000-t1n.nii.gz,../../DataSet/ASNR-MICCAI-BraTS2023-GLI-Challenge-TrainingData/BraTS-GLI-01524-000/BraTS-GLI-01524-000-seg.nii.gz,81,129,75,54,113,86,170,45,102,59,84,57
01252-000,../../DataSet/ASNR-MICCAI-BraTS2023-GLI-Challenge-TrainingData/BraTS-GLI-01252-000/BraTS-GLI-01252-000-t1c.nii.gz,../../DataSet/ASNR-MICCAI-BraTS2023-GLI-Challenge-TrainingData/BraTS-GLI-01252-000/BraTS-GLI-01252-000-t2w.nii.gz,../../DataSet/ASNR-MICCAI-BraTS2023-GLI-Challenge-TrainingData/BraTS-GLI-01252-000/BraTS-GLI-01252-000-t2f.nii.gz,../../DataSet/ASNR-MICCAI-BraTS2023-GLI-Challenge-TrainingData/BraTS-GLI-01252-000/BraTS-GLI-01252-000-t1n.nii.gz,../../DataSet/ASNR-MICCAI-BraTS2023-GLI-Challenge-TrainingData/BraTS-GLI-01252-000/BraTS-GLI-01252-000-seg.nii.gz,128,169,81,119,146,150,189,57,102,27,39,45
00412-000,../../DataSet/ASNR-MICCAI-BraTS2023-GLI-Challenge-TrainingData/BraTS-GLI-00412-000/BraTS-GLI-00412-000-t1c.nii.gz,../../DataSet/ASNR-MICCAI-BraTS2023-GLI-Challenge-TrainingData/BraTS-GLI-00412-000/BraTS-GLI-00412-000-t2w.nii.gz,../../DataSet/ASNR-MICCAI-BraTS2023-GLI-Challenge-TrainingData/BraTS-GLI-00412-000/BraTS-GLI-00412-000-t2f.nii.gz,../../DataSet/ASNR-MICCAI-BraTS2023-GLI-Challenge-TrainingData/BraTS-GLI-00412-000/BraTS-GLI-00412-000-t1n.nii.gz,../../DataSet/ASNR-MICCAI-BraTS2023-GLI-Challenge-TrainingData/BraTS-GLI-00412-000/BraTS-GLI-00412-000-seg.nii.gz,162,145,93,143,185,116,176,70,123,42,60,53
01194-000,../../DataSet/ASNR-MICCAI-BraTS2023-GLI-Challenge-TrainingData/BraTS-GLI-01194-000/BraTS-GLI-01194-000-t1c.nii.gz,../../DataSet/ASNR-MICCAI-BraTS2023-GLI-Challenge-TrainingData/BraTS-GLI-01194-000/BraTS-GLI-01194-000-t2w.nii.gz,../../DataSet/ASNR-MICCAI-BraTS2023-GLI-Challenge-TrainingData/BraTS-GLI-01194-000/BraTS-GLI-01194-000-t2f.nii.gz,../../DataSet/ASNR-MICCAI-BraTS2023-GLI-Challenge-TrainingData/BraTS-GLI-01194-000/BraTS-GLI-01194-000-t1n.nii.gz,../../DataSet/ASNR-MICCAI-BraTS2023-GLI-Challenge-TrainingData/BraTS-GLI-01194-000/BraTS-GLI-01194-000-seg.nii.gz,142,90,70,113,176,46,135,30,104,63,89,74
01139-000,../../DataSet/ASNR-MICCAI-BraTS2023-GLI-Challenge-TrainingData/BraTS-GLI-01139-000/BraTS-GLI-01139-000-t1c.nii.gz,../../DataSet/ASNR-MICCAI-BraTS2023-GLI-Challenge-TrainingData/BraTS-GLI-01139-000/BraTS-GLI-01139-000-t2w.nii.gz,../../DataSet/ASNR-MICCAI-BraTS2023-GLI-Challenge-TrainingData/BraTS-GLI-01139-000/BraTS-GLI-01139-000-t2f.nii.gz,../../DataSet/ASNR-MICCAI-BraTS2023-GLI-Challenge-TrainingData/BraTS-GLI-01139-000/BraTS-GLI-01139-000-t1n.nii.gz,../../DataSet/ASNR-MICCAI-BraTS2023-GLI-Challenge-TrainingData/BraTS-GLI-01139-000/BraTS-GLI-01139-000-seg.nii.gz,95,170,73,63,148,134,210,37,121,85,76,84
00318-000,../../DataSet/ASNR-MICCAI-BraTS2023-GLI-Challenge-TrainingData/BraTS-GLI-00318-000/BraTS-GLI-00318-000-t1c.nii.gz,../../DataSet/ASNR-MICCAI-BraTS2023-GLI-Challenge-TrainingData/BraTS-GLI-00318-000/BraTS-GLI-00318-000-t2w.nii.gz,../../DataSet/ASNR-MICCAI-BraTS2023-GLI-Challenge-TrainingData/BraTS-GLI-00318-000/BraTS-GLI-00318-000-t2f.nii.gz,../../DataSet/ASNR-MICCAI-BraTS2023-GLI-Challenge-TrainingData/BraTS-GLI-00318-000/BraTS-GLI-00318-000-t1n.nii.gz,../../DataSet/ASNR-MICCAI-BraTS2023-GLI-Challenge-TrainingData/BraTS-GLI-00318-000/BraTS-GLI-00318-000-seg.nii.gz,129,71,61,81,174,30,121,31,101,93,91,70
01376-000,../../DataSet/ASNR-MICCAI-BraTS2023-GLI-Challenge-TrainingData/BraTS-GLI-01376-000/BraTS-GLI-01376-000-t1c.nii.gz,../../DataSet/ASNR-MICCAI-BraTS2023-GLI-Challenge-TrainingData/BraTS-GLI-01376-000/BraTS-GLI-01376-000-t2w.nii.gz,../../DataSet/ASNR-MICCAI-BraTS2023-GLI-Challenge-TrainingData/BraTS-GLI-01376-000/BraTS-GLI-01376-000-t2f.nii.gz,../../DataSet/ASNR-MICCAI-BraTS2023-GLI-Challenge-TrainingData/BraTS-GLI-01376-000/BraTS-GLI-01376-000-t1n.nii.gz,../../DataSet/ASNR-MICCAI-BraTS2023-GLI-Challenge-TrainingData/BraTS-GLI-01376-000/BraTS-GLI-01376-000-seg.nii.gz,140,163,109,120,174,140,192,58,138,54,52,80
00291-000,../../DataSet/ASNR-MICCAI-BraTS2023-GLI-Challenge-TrainingData/BraTS-GLI-00291-000/BraTS-GLI-00291-000-t1c.nii.gz,../../DataSet/ASNR-MICCAI-BraTS2023-GLI-Challenge-TrainingData/BraTS-GLI-00291-000/BraTS-GLI-00291-000-t2w.nii.gz,../../DataSet/ASNR-MICCAI-BraTS2023-GLI-Challenge-TrainingData/BraTS-GLI-00291-000/BraTS-GLI-00291-000-t2f.nii.gz,../../DataSet/ASNR-MICCAI-BraTS2023-GLI-Challenge-TrainingData/BraTS-GLI-00291-000/BraTS-GLI-00291-000-t1n.nii.gz,../../DataSet/ASNR-MICCAI-BraTS2023-GLI-Challenge-TrainingData/BraTS-GLI-00291-000/BraTS-GLI-00291-000-seg.nii.gz,92,169,90,55,119,135,201,40,126,64,66,86
00772-001,../../DataSet/ASNR-MICCAI-BraTS2023-GLI-Challenge-TrainingData/BraTS-GLI-00772-001/BraTS-GLI-00772-001-t1c.nii.gz,../../DataSet/ASNR-MICCAI-BraTS2023-GLI-Challenge-TrainingData/BraTS-GLI-00772-001/BraTS-GLI-00772-001-t2w.nii.gz,../../DataSet/ASNR-MICCAI-BraTS2023-GLI-Challenge-TrainingData/BraTS-GLI-00772-001/BraTS-GLI-00772-001-t2f.nii.gz,../../DataSet/ASNR-MICCAI-BraTS2023-GLI-Challenge-TrainingData/BraTS-GLI-00772-001/BraTS-GLI-00772-001-t1n.nii.gz,../../DataSet/ASNR-MICCAI-BraTS2023-GLI-Challenge-TrainingData/BraTS-GLI-00772-001/BraTS-GLI-00772-001-seg.nii.gz,156,137,62,138,177,111,164,44,81,39,53,37
00157-000,../../DataSet/ASNR-MICCAI-BraTS2023-GLI-Challenge-TrainingData/BraTS-GLI-00157-000/BraTS-GLI-00157-000-t1c.nii.gz,../../DataSet/ASNR-MICCAI-BraTS2023-GLI-Challenge-TrainingData/BraTS-GLI-00157-000/BraTS-GLI-00157-000-t2w.nii.gz,../../DataSet/ASNR-MICCAI-BraTS2023-GLI-Challenge-TrainingData/BraTS-GLI-00157-000/BraTS-GLI-00157-000-t2f.nii.gz,../../DataSet/ASNR-MICCAI-BraTS2023-GLI-Challenge-TrainingData/BraTS-GLI-00157-000/BraTS-GLI-00157-000-t1n.nii.gz,../../DataSet/ASNR-MICCAI-BraTS2023-GLI-Challenge-TrainingData/BraTS-GLI-00157-000/BraTS-GLI-00157-000-seg.nii.gz,162,152,49,140,186,123,179,27,71,46,56,44
00621-000,../../DataSet/ASNR-MICCAI-BraTS2023-GLI-Challenge-TrainingData/BraTS-GLI-00621-000/BraTS-GLI-00621-000-t1c.nii.gz,../../DataSet/ASNR-MICCAI-BraTS2023-GLI-Challenge-TrainingData/BraTS-GLI-00621-000/BraTS-GLI-00621-000-t2w.nii.gz,../../DataSet/ASNR-MICCAI-BraTS2023-GLI-Challenge-TrainingData/BraTS-GLI-00621-000/BraTS-GLI-00621-000-t2f.nii.gz,../../DataSet/ASNR-MICCAI-BraTS2023-GLI-Challenge-TrainingData/BraTS-GLI-00621-000/BraTS-GLI-00621-000-t1n.nii.gz,../../DataSet/ASNR-MICCAI-BraTS2023-GLI-Challenge-TrainingData/BraTS-GLI-00621-000/BraTS-GLI-00621-000-seg.nii.gz,143,87,68,111,164,62,132,34,96,53,70,62
00240-000,../../DataSet/ASNR-MICCAI-BraTS2023-GLI-Challenge-TrainingData/BraTS-GLI-00240-000/BraTS-GLI-00240-000-t1c.nii.gz,../../DataSet/ASNR-MICCAI-BraTS2023-GLI-Challenge-TrainingData/BraTS-GLI-00240-000/BraTS-GLI-00240-000-t2w.nii.gz,../../DataSet/ASNR-MICCAI-BraTS2023-GLI-Challenge-TrainingData/BraTS-GLI-00240-000/BraTS-GLI-00240-000-t2f.nii.gz,../../DataSet/ASNR-MICCAI-BraTS2023-GLI-Challenge-TrainingData/BraTS-GLI-00240-000/BraTS-GLI-00240-000-t1n.nii.gz,../../DataSet/ASNR-MICCAI-BraTS2023-GLI-Challenge-TrainingData/BraTS-GLI-00240-000/BraTS-GLI-00240-000-seg.nii.gz,104,100,101,72,137,53,149,72,137,65,96,65
01108-000,../../DataSet/ASNR-MICCAI-BraTS2023-GLI-Challenge-TrainingData/BraTS-GLI-01108-000/BraTS-GLI-01108-000-t1c.nii.gz,../../DataSet/ASNR-MICCAI-BraTS2023-GLI-Challenge-TrainingData/BraTS-GLI-01108-000/BraTS-GLI-01108-000-t2w.nii.gz,../../DataSet/ASNR-MICCAI-BraTS2023-GLI-Challenge-TrainingData/BraTS-GLI-01108-000/BraTS-GLI-01108-000-t2f.nii.gz,../../DataSet/ASNR-MICCAI-BraTS2023-GLI-Challenge-TrainingData/BraTS-GLI-01108-000/BraTS-GLI-01108-000-t1n.nii.gz,../../DataSet/ASNR-MICCAI-BraTS2023-GLI-Challenge-TrainingData/BraTS-GLI-01108-000/BraTS-GLI-01108-000-seg.nii.gz,70,148,58,58,83,134,165,49,70,25,31,21
01050-000,../../DataSet/ASNR-MICCAI-BraTS2023-GLI-Challenge-TrainingData/BraTS-GLI-01050-000/BraTS-GLI-01050-000-t1c.nii.gz,../../DataSet/ASNR-MICCAI-BraTS2023-GLI-Challenge-TrainingData/BraTS-GLI-01050-000/BraTS-GLI-01050-000-t2w.nii.gz,../../DataSet/ASNR-MICCAI-BraTS2023-GLI-Challenge-TrainingData/BraTS-GLI-01050-000/BraTS-GLI-01050-000-t2f.nii.gz,../../DataSet/ASNR-MICCAI-BraTS2023-GLI-Challenge-TrainingData/BraTS-GLI-01050-000/BraTS-GLI-01050-000-t1n.nii.gz,../../DataSet/ASNR-MICCAI-BraTS2023-GLI-Challenge-TrainingData/BraTS-GLI-01050-000/BraTS-GLI-01050-000-seg.nii.gz,131,152,74,83,155,111,198,51,104,72,87,53
00610-000,../../DataSet/ASNR-MICCAI-BraTS2023-GLI-Challenge-TrainingData/BraTS-GLI-00610-000/BraTS-GLI-00610-000-t1c.nii.gz,../../DataSet/ASNR-MICCAI-BraTS2023-GLI-Challenge-TrainingData/BraTS-GLI-00610-000/BraTS-GLI-00610-000-t2w.nii.gz,../../DataSet/ASNR-MICCAI-BraTS2023-GLI-Challenge-TrainingData/BraTS-GLI-00610-000/BraTS-GLI-00610-000-t2f.nii.gz,../../DataSet/ASNR-MICCAI-BraTS2023-GLI-Challenge-TrainingData/BraTS-GLI-00610-000/BraTS-GLI-00610-000-t1n.nii.gz,../../DataSet/ASNR-MICCAI-BraTS2023-GLI-Challenge-TrainingData/BraTS-GLI-00610-000/BraTS-GLI-00610-000-seg.nii.gz,76,104,92,55,103,70,134,54,129,48,64,75
01396-000,../../DataSet/ASNR-MICCAI-BraTS2023-GLI-Challenge-TrainingData/BraTS-GLI-01396-000/BraTS-GLI-01396-000-t1c.nii.gz,../../DataSet/ASNR-MICCAI-BraTS2023-GLI-Challenge-TrainingData/BraTS-GLI-01396-000/BraTS-GLI-01396-000-t2w.nii.gz,../../DataSet/ASNR-MICCAI-BraTS2023-GLI-Challenge-TrainingData/BraTS-GLI-01396-000/BraTS-GLI-01396-000-t2f.nii.gz,../../DataSet/ASNR-MICCAI-BraTS2023-GLI-Challenge-TrainingData/BraTS-GLI-01396-000/BraTS-GLI-01396-000-t1n.nii.gz,../../DataSet/ASNR-MICCAI-BraTS2023-GLI-Challenge-TrainingData/BraTS-GLI-01396-000/BraTS-GLI-01396-000-seg.nii.gz,150,176,81,127,178,149,210,51,115,51,61,64
01431-000,../../DataSet/ASNR-MICCAI-BraTS2023-GLI-Challenge-TrainingData/BraTS-GLI-01431-000/BraTS-GLI-01431-000-t1c.nii.gz,../../DataSet/ASNR-MICCAI-BraTS2023-GLI-Challenge-TrainingData/BraTS-GLI-01431-000/BraTS-GLI-01431-000-t2w.nii.gz,../../DataSet/ASNR-MICCAI-BraTS2023-GLI-Challenge-TrainingData/BraTS-GLI-01431-000/BraTS-GLI-01431-000-t2f.nii.gz,../../DataSet/ASNR-MICCAI-BraTS2023-GLI-Challenge-TrainingData/BraTS-GLI-01431-000/BraTS-GLI-01431-000-t1n.nii.gz,../../DataSet/ASNR-MICCAI-BraTS2023-GLI-Challenge-TrainingData/BraTS-GLI-01431-000/BraTS-GLI-01431-000-seg.nii.gz,106,134,60,78,131,110,161,36,83,53,51,47
01347-000,../../DataSet/ASNR-MICCAI-BraTS2023-GLI-Challenge-TrainingData/BraTS-GLI-01347-000/BraTS-GLI-01347-000-t1c.nii.gz,../../DataSet/ASNR-MICCAI-BraTS2023-GLI-Challenge-TrainingData/BraTS-GLI-01347-000/BraTS-GLI-01347-000-t2w.nii.gz,../../DataSet/ASNR-MICCAI-BraTS2023-GLI-Challenge-TrainingData/BraTS-GLI-01347-000/BraTS-GLI-01347-000-t2f.nii.gz,../../DataSet/ASNR-MICCAI-BraTS2023-GLI-Challenge-TrainingData/BraTS-GLI-01347-000/BraTS-GLI-01347-000-t1n.nii.gz,../../DataSet/ASNR-MICCAI-BraTS2023-GLI-Challenge-TrainingData/BraTS-GLI-01347-000/BraTS-GLI-01347-000-seg.nii.gz,134,84,76,100,163,52,139,55,108,63,87,53
00507-000,../../DataSet/ASNR-MICCAI-BraTS2023-GLI-Challenge-TrainingData/BraTS-GLI-00507-000/BraTS-GLI-00507-000-t1c.nii.gz,../../DataSet/ASNR-MICCAI-BraTS2023-GLI-Challenge-TrainingData/BraTS-GLI-00507-000/BraTS-GLI-00507-000-t2w.nii.gz,../../DataSet/ASNR-MICCAI-BraTS2023-GLI-Challenge-TrainingData/BraTS-GLI-00507-000/BraTS-GLI-00507-000-t2f.nii.gz,../../DataSet/ASNR-MICCAI-BraTS2023-GLI-Challenge-TrainingData/BraTS-GLI-00507-000/BraTS-GLI-00507-000-t1n.nii.gz,../../DataSet/ASNR-MICCAI-BraTS2023-GLI-Challenge-TrainingData/BraTS-GLI-00507-000/BraTS-GLI-00507-000-seg.nii.gz,134,87,79,97,171,42,135,45,119,74,93,74
00485-001,../../DataSet/ASNR-MICCAI-BraTS2023-GLI-Challenge-TrainingData/BraTS-GLI-00485-001/BraTS-GLI-00485-001-t1c.nii.gz,../../DataSet/ASNR-MICCAI-BraTS2023-GLI-Challenge-TrainingData/BraTS-GLI-00485-001/BraTS-GLI-00485-001-t2w.nii.gz,../../DataSet/ASNR-MICCAI-BraTS2023-GLI-Challenge-TrainingData/BraTS-GLI-00485-001/BraTS-GLI-00485-001-t2f.nii.gz,../../DataSet/ASNR-MICCAI-BraTS2023-GLI-Challenge-TrainingData/BraTS-GLI-00485-001/BraTS-GLI-00485-001-t1n.nii.gz,../../DataSet/ASNR-MICCAI-BraTS2023-GLI-Challenge-TrainingData/BraTS-GLI-00485-001/BraTS-GLI-00485-001-seg.nii.gz,155,119,62,120,180,92,152,38,87,60,60,49
00166-000,../../DataSet/ASNR-MICCAI-BraTS2023-GLI-Challenge-TrainingData/BraTS-GLI-00166-000/BraTS-GLI-00166-000-t1c.nii.gz,../../DataSet/ASNR-MICCAI-BraTS2023-GLI-Challenge-TrainingData/BraTS-GLI-00166-000/BraTS-GLI-00166-000-t2w.nii.gz,../../DataSet/ASNR-MICCAI-BraTS2023-GLI-Challenge-TrainingData/BraTS-GLI-00166-000/BraTS-GLI-00166-000-t2f.nii.gz,../../DataSet/ASNR-MICCAI-BraTS2023-GLI-Challenge-TrainingData/BraTS-GLI-00166-000/BraTS-GLI-00166-000-t1n.nii.gz,../../DataSet/ASNR-MICCAI-BraTS2023-GLI-Challenge-TrainingData/BraTS-GLI-00166-000/BraTS-GLI-00166-000-seg.nii.gz,102,91,96,68,152,54,130,67,129,84,76,62
01081-000,../../DataSet/ASNR-MICCAI-BraTS2023-GLI-Challenge-TrainingData/BraTS-GLI-01081-000/BraTS-GLI-01081-000-t1c.nii.gz,../../DataSet/ASNR-MICCAI-BraTS2023-GLI-Challenge-TrainingData/BraTS-GLI-01081-000/BraTS-GLI-01081-000-t2w.nii.gz,../../DataSet/ASNR-MICCAI-BraTS2023-GLI-Challenge-TrainingData/BraTS-GLI-01081-000/BraTS-GLI-01081-000-t2f.nii.gz,../../DataSet/ASNR-MICCAI-BraTS2023-GLI-Challenge-TrainingData/BraTS-GLI-01081-000/BraTS-GLI-01081-000-t1n.nii.gz,../../DataSet/ASNR-MICCAI-BraTS2023-GLI-Challenge-TrainingData/BraTS-GLI-01081-000/BraTS-GLI-01081-000-seg.nii.gz,152,156,67,111,184,125,185,36,95,73,60,59
00423-000,../../DataSet/ASNR-MICCAI-BraTS2023-GLI-Challenge-TrainingData/BraTS-GLI-00423-000/BraTS-GLI-00423-000-t1c.nii.gz,../../DataSet/ASNR-MICCAI-BraTS2023-GLI-Challenge-TrainingData/BraTS-GLI-00423-000/BraTS-GLI-00423-000-t2w.nii.gz,../../DataSet/ASNR-MICCAI-BraTS2023-GLI-Challenge-TrainingData/BraTS-GLI-00423-000/BraTS-GLI-00423-000-t2f.nii.gz,../../DataSet/ASNR-MICCAI-BraTS2023-GLI-Challenge-TrainingData/BraTS-GLI-00423-000/BraTS-GLI-00423-000-t1n.nii.gz,../../DataSet/ASNR-MICCAI-BraTS2023-GLI-Challenge-TrainingData/BraTS-GLI-00423-000/BraTS-GLI-00423-000-seg.nii.gz,112,108,94,71,152,75,145,54,128,81,70,74
01174-000,../../DataSet/ASNR-MICCAI-BraTS2023-GLI-Challenge-TrainingData/BraTS-GLI-01174-000/BraTS-GLI-01174-000-t1c.nii.gz,../../DataSet/ASNR-MICCAI-BraTS2023-GLI-Challenge-TrainingData/BraTS-GLI-01174-000/BraTS-GLI-01174-000-t2w.nii.gz,../../DataSet/ASNR-MICCAI-BraTS2023-GLI-Challenge-TrainingData/BraTS-GLI-01174-000/BraTS-GLI-01174-000-t2f.nii.gz,../../DataSet/ASNR-MICCAI-BraTS2023-GLI-Challenge-TrainingData/BraTS-GLI-01174-000/BraTS-GLI-01174-000-t1n.nii.gz,../../DataSet/ASNR-MICCAI-BraTS2023-GLI-Challenge-TrainingData/BraTS-GLI-01174-000/BraTS-GLI-01174-000-seg.nii.gz,139,157,99,116,166,124,193,69,131,50,69,62
00383-000,../../DataSet/ASNR-MICCAI-BraTS2023-GLI-Challenge-TrainingData/BraTS-GLI-00383-000/BraTS-GLI-00383-000-t1c.nii.gz,../../DataSet/ASNR-MICCAI-BraTS2023-GLI-Challenge-TrainingData/BraTS-GLI-00383-000/BraTS-GLI-00383-000-t2w.nii.gz,../../DataSet/ASNR-MICCAI-BraTS2023-GLI-Challenge-TrainingData/BraTS-GLI-00383-000/BraTS-GLI-00383-000-t2f.nii.gz,../../DataSet/ASNR-MICCAI-BraTS2023-GLI-Challenge-TrainingData/BraTS-GLI-00383-000/BraTS-GLI-00383-000-t1n.nii.gz,../../DataSet/ASNR-MICCAI-BraTS2023-GLI-Challenge-TrainingData/BraTS-GLI-00383-000/BraTS-GLI-00383-000-seg.nii.gz,85,157,95,55,110,102,198,65,128,55,96,63
01264-000,../../DataSet/ASNR-MICCAI-BraTS2023-GLI-Challenge-TrainingData/BraTS-GLI-01264-000/BraTS-GLI-01264-000-t1c.nii.gz,../../DataSet/ASNR-MICCAI-BraTS2023-GLI-Challenge-TrainingData/BraTS-GLI-01264-000/BraTS-GLI-01264-000-t2w.nii.gz,../../DataSet/ASNR-MICCAI-BraTS2023-GLI-Challenge-TrainingData/BraTS-GLI-01264-000/BraTS-GLI-01264-000-t2f.nii.gz,../../DataSet/ASNR-MICCAI-BraTS2023-GLI-Challenge-TrainingData/BraTS-GLI-01264-000/BraTS-GLI-01264-000-t1n.nii.gz,../../DataSet/ASNR-MICCAI-BraTS2023-GLI-Challenge-TrainingData/BraTS-GLI-01264-000/BraTS-GLI-01264-000-seg.nii.gz,132,156,99,120,152,90,180,80,122,32,90,42
00045-000,../../DataSet/ASNR-MICCAI-BraTS2023-GLI-Challenge-TrainingData/BraTS-GLI-00045-000/BraTS-GLI-00045-000-t1c.nii.gz,../../DataSet/ASNR-MICCAI-BraTS2023-GLI-Challenge-TrainingData/BraTS-GLI-00045-000/BraTS-GLI-00045-000-t2w.nii.gz,../../DataSet/ASNR-MICCAI-BraTS2023-GLI-Challenge-TrainingData/BraTS-GLI-00045-000/BraTS-GLI-00045-000-t2f.nii.gz,../../DataSet/ASNR-MICCAI-BraTS2023-GLI-Challenge-TrainingData/BraTS-GLI-00045-000/BraTS-GLI-00045-000-t1n.nii.gz,../../DataSet/ASNR-MICCAI-BraTS2023-GLI-Challenge-TrainingData/BraTS-GLI-00045-000/BraTS-GLI-00045-000-seg.nii.gz,162,102,55,144,182,79,133,32,79,38,54,47
00094-000,../../DataSet/ASNR-MICCAI-BraTS2023-GLI-Challenge-TrainingData/BraTS-GLI-00094-000/BraTS-GLI-00094-000-t1c.nii.gz,../../DataSet/ASNR-MICCAI-BraTS2023-GLI-Challenge-TrainingData/BraTS-GLI-00094-000/BraTS-GLI-00094-000-t2w.nii.gz,../../DataSet/ASNR-MICCAI-BraTS2023-GLI-Challenge-TrainingData/BraTS-GLI-00094-000/BraTS-GLI-00094-000-t2f.nii.gz,../../DataSet/ASNR-MICCAI-BraTS2023-GLI-Challenge-TrainingData/BraTS-GLI-00094-000/BraTS-GLI-00094-000-t1n.nii.gz,../../DataSet/ASNR-MICCAI-BraTS2023-GLI-Challenge-TrainingData/BraTS-GLI-00094-000/BraTS-GLI-00094-000-seg.nii.gz,85,158,85,56,117,120,199,51,128,61,79,77
00733-000,../../DataSet/ASNR-MICCAI-BraTS2023-GLI-Challenge-TrainingData/BraTS-GLI-00733-000/BraTS-GLI-00733-000-t1c.nii.gz,../../DataSet/ASNR-MICCAI-BraTS2023-GLI-Challenge-TrainingData/BraTS-GLI-00733-000/BraTS-GLI-00733-000-t2w.nii.gz,../../DataSet/ASNR-MICCAI-BraTS2023-GLI-Challenge-TrainingData/BraTS-GLI-00733-000/BraTS-GLI-00733-000-t2f.nii.gz,../../DataSet/ASNR-MICCAI-BraTS2023-GLI-Challenge-TrainingData/BraTS-GLI-00733-000/BraTS-GLI-00733-000-t1n.nii.gz,../../DataSet/ASNR-MICCAI-BraTS2023-GLI-Challenge-TrainingData/BraTS-GLI-00733-000/BraTS-GLI-00733-000-seg.nii.gz,76,150,81,50,103,122,182,53,112,53,60,59
01173-000,../../DataSet/ASNR-MICCAI-BraTS2023-GLI-Challenge-TrainingData/BraTS-GLI-01173-000/BraTS-GLI-01173-000-t1c.nii.gz,../../DataSet/ASNR-MICCAI-BraTS2023-GLI-Challenge-TrainingData/BraTS-GLI-01173-000/BraTS-GLI-01173-000-t2w.nii.gz,../../DataSet/ASNR-MICCAI-BraTS2023-GLI-Challenge-TrainingData/BraTS-GLI-01173-000/BraTS-GLI-01173-000-t2f.nii.gz,../../DataSet/ASNR-MICCAI-BraTS2023-GLI-Challenge-TrainingData/BraTS-GLI-01173-000/BraTS-GLI-01173-000-t1n.nii.gz,../../DataSet/ASNR-MICCAI-BraTS2023-GLI-Challenge-TrainingData/BraTS-GLI-01173-000/BraTS-GLI-01173-000-seg.nii.gz,159,110,60,138,183,84,146,28,88,45,62,60
00352-000,../../DataSet/ASNR-MICCAI-BraTS2023-GLI-Challenge-TrainingData/BraTS-GLI-00352-000/BraTS-GLI-00352-000-t1c.nii.gz,../../DataSet/ASNR-MICCAI-BraTS2023-GLI-Challenge-TrainingData/BraTS-GLI-00352-000/BraTS-GLI-00352-000-t2w.nii.gz,../../DataSet/ASNR-MICCAI-BraTS2023-GLI-Challenge-TrainingData/BraTS-GLI-00352-000/BraTS-GLI-00352-000-t2f.nii.gz,../../DataSet/ASNR-MICCAI-BraTS2023-GLI-Challenge-TrainingData/BraTS-GLI-00352-000/BraTS-GLI-00352-000-t1n.nii.gz,../../DataSet/ASNR-MICCAI-BraTS2023-GLI-Challenge-TrainingData/BraTS-GLI-00352-000/BraTS-GLI-00352-000-seg.nii.gz,78,155,63,55,100,122,182,41,90,45,60,49
01218-000,../../DataSet/ASNR-MICCAI-BraTS2023-GLI-Challenge-TrainingData/BraTS-GLI-01218-000/BraTS-GLI-01218-000-t1c.nii.gz,../../DataSet/ASNR-MICCAI-BraTS2023-GLI-Challenge-TrainingData/BraTS-GLI-01218-000/BraTS-GLI-01218-000-t2w.nii.gz,../../DataSet/ASNR-MICCAI-BraTS2023-GLI-Challenge-TrainingData/BraTS-GLI-01218-000/BraTS-GLI-01218-000-t2f.nii.gz,../../DataSet/ASNR-MICCAI-BraTS2023-GLI-Challenge-TrainingData/BraTS-GLI-01218-000/BraTS-GLI-01218-000-t1n.nii.gz,../../DataSet/ASNR-MICCAI-BraTS2023-GLI-Challenge-TrainingData/BraTS-GLI-01218-000/BraTS-GLI-01218-000-seg.nii.gz,107,155,77,76,155,116,194,49,104,79,78,55
00032-001,../../DataSet/ASNR-MICCAI-BraTS2023-GLI-Challenge-TrainingData/BraTS-GLI-00032-001/BraTS-GLI-00032-001-t1c.nii.gz,../../DataSet/ASNR-MICCAI-BraTS2023-GLI-Challenge-TrainingData/BraTS-GLI-00032-001/BraTS-GLI-00032-001-t2w.nii.gz,../../DataSet/ASNR-MICCAI-BraTS2023-GLI-Challenge-TrainingData/BraTS-GLI-00032-001/BraTS-GLI-00032-001-t2f.nii.gz,../../DataSet/ASNR-MICCAI-BraTS2023-GLI-Challenge-TrainingData/BraTS-GLI-00032-001/BraTS-GLI-00032-001-t1n.nii.gz,../../DataSet/ASNR-MICCAI-BraTS2023-GLI-Challenge-TrainingData/BraTS-GLI-00032-001/BraTS-GLI-00032-001-seg.nii.gz,156,146,85,130,184,105,191,48,122,54,86,74
01436-000,../../DataSet/ASNR-MICCAI-BraTS2023-GLI-Challenge-TrainingData/BraTS-GLI-01436-000/BraTS-GLI-01436-000-t1c.nii.gz,../../DataSet/ASNR-MICCAI-BraTS2023-GLI-Challenge-TrainingData/BraTS-GLI-01436-000/BraTS-GLI-01436-000-t2w.nii.gz,../../DataSet/ASNR-MICCAI-BraTS2023-GLI-Challenge-TrainingData/BraTS-GLI-01436-000/BraTS-GLI-01436-000-t2f.nii.gz,../../DataSet/ASNR-MICCAI-BraTS2023-GLI-Challenge-TrainingData/BraTS-GLI-01436-000/BraTS-GLI-01436-000-t1n.nii.gz,../../DataSet/ASNR-MICCAI-BraTS2023-GLI-Challenge-TrainingData/BraTS-GLI-01436-000/BraTS-GLI-01436-000-seg.nii.gz,150,122,84,128,172,94,153,55,110,44,59,55
01391-000,../../DataSet/ASNR-MICCAI-BraTS2023-GLI-Challenge-TrainingData/BraTS-GLI-01391-000/BraTS-GLI-01391-000-t1c.nii.gz,../../DataSet/ASNR-MICCAI-BraTS2023-GLI-Challenge-TrainingData/BraTS-GLI-01391-000/BraTS-GLI-01391-000-t2w.nii.gz,../../DataSet/ASNR-MICCAI-BraTS2023-GLI-Challenge-TrainingData/BraTS-GLI-01391-000/BraTS-GLI-01391-000-t2f.nii.gz,../../DataSet/ASNR-MICCAI-BraTS2023-GLI-Challenge-TrainingData/BraTS-GLI-01391-000/BraTS-GLI-01391-000-t1n.nii.gz,../../DataSet/ASNR-MICCAI-BraTS2023-GLI-Challenge-TrainingData/BraTS-GLI-01391-000/BraTS-GLI-01391-000-seg.nii.gz,142,166,84,110,173,117,206,42,132,63,89,90
00500-000,../../DataSet/ASNR-MICCAI-BraTS2023-GLI-Challenge-TrainingData/BraTS-GLI-00500-000/BraTS-GLI-00500-000-t1c.nii.gz,../../DataSet/ASNR-MICCAI-BraTS2023-GLI-Challenge-TrainingData/BraTS-GLI-00500-000/BraTS-GLI-00500-000-t2w.nii.gz,../../DataSet/ASNR-MICCAI-BraTS2023-GLI-Challenge-TrainingData/BraTS-GLI-00500-000/BraTS-GLI-00500-000-t2f.nii.gz,../../DataSet/ASNR-MICCAI-BraTS2023-GLI-Challenge-TrainingData/BraTS-GLI-00500-000/BraTS-GLI-00500-000-t1n.nii.gz,../../DataSet/ASNR-MICCAI-BraTS2023-GLI-Challenge-TrainingData/BraTS-GLI-00500-000/BraTS-GLI-00500-000-seg.nii.gz,159,100,89,136,182,66,134,63,122,46,68,59
01340-000,../../DataSet/ASNR-MICCAI-BraTS2023-GLI-Challenge-TrainingData/BraTS-GLI-01340-000/BraTS-GLI-01340-000-t1c.nii.gz,../../DataSet/ASNR-MICCAI-BraTS2023-GLI-Challenge-TrainingData/BraTS-GLI-01340-000/BraTS-GLI-01340-000-t2w.nii.gz,../../DataSet/ASNR-MICCAI-BraTS2023-GLI-Challenge-TrainingData/BraTS-GLI-01340-000/BraTS-GLI-01340-000-t2f.nii.gz,../../DataSet/ASNR-MICCAI-BraTS2023-GLI-Challenge-TrainingData/BraTS-GLI-01340-000/BraTS-GLI-01340-000-t1n.nii.gz,../../DataSet/ASNR-MICCAI-BraTS2023-GLI-Challenge-TrainingData/BraTS-GLI-01340-000/BraTS-GLI-01340-000-seg.nii.gz,105,152,96,86,142,117,186,58,116,56,69,58
01086-000,../../DataSet/ASNR-MICCAI-BraTS2023-GLI-Challenge-TrainingData/BraTS-GLI-01086-000/BraTS-GLI-01086-000-t1c.nii.gz,../../DataSet/ASNR-MICCAI-BraTS2023-GLI-Challenge-TrainingData/BraTS-GLI-01086-000/BraTS-GLI-01086-000-t2w.nii.gz,../../DataSet/ASNR-MICCAI-BraTS2023-GLI-Challenge-TrainingData/BraTS-GLI-01086-000/BraTS-GLI-01086-000-t2f.nii.gz,../../DataSet/ASNR-MICCAI-BraTS2023-GLI-Challenge-TrainingData/BraTS-GLI-01086-000/BraTS-GLI-01086-000-t1n.nii.gz,../../DataSet/ASNR-MICCAI-BraTS2023-GLI-Challenge-TrainingData/BraTS-GLI-01086-000/BraTS-GLI-01086-000-seg.nii.gz,138,111,112,119,171,66,151,89,142,52,85,53
01025-000,../../DataSet/ASNR-MICCAI-BraTS2023-GLI-Challenge-TrainingData/BraTS-GLI-01025-000/BraTS-GLI-01025-000-t1c.nii.gz,../../DataSet/ASNR-MICCAI-BraTS2023-GLI-Challenge-TrainingData/BraTS-GLI-01025-000/BraTS-GLI-01025-000-t2w.nii.gz,../../DataSet/ASNR-MICCAI-BraTS2023-GLI-Challenge-TrainingData/BraTS-GLI-01025-000/BraTS-GLI-01025-000-t2f.nii.gz,../../DataSet/ASNR-MICCAI-BraTS2023-GLI-Challenge-TrainingData/BraTS-GLI-01025-000/BraTS-GLI-01025-000-t1n.nii.gz,../../DataSet/ASNR-MICCAI-BraTS2023-GLI-Challenge-TrainingData/BraTS-GLI-01025-000/BraTS-GLI-01025-000-seg.nii.gz,138,122,113,118,159,98,149,89,137,41,51,48
00204-000,../../DataSet/ASNR-MICCAI-BraTS2023-GLI-Challenge-TrainingData/BraTS-GLI-00204-000/BraTS-GLI-00204-000-t1c.nii.gz,../../DataSet/ASNR-MICCAI-BraTS2023-GLI-Challenge-TrainingData/BraTS-GLI-00204-000/BraTS-GLI-00204-000-t2w.nii.gz,../../DataSet/ASNR-MICCAI-BraTS2023-GLI-Challenge-TrainingData/BraTS-GLI-00204-000/BraTS-GLI-00204-000-t2f.nii.gz,../../DataSet/ASNR-MICCAI-BraTS2023-GLI-Challenge-TrainingData/BraTS-GLI-00204-000/BraTS-GLI-00204-000-t1n.nii.gz,../../DataSet/ASNR-MICCAI-BraTS2023-GLI-Challenge-TrainingData/BraTS-GLI-00204-000/BraTS-GLI-00204-000-seg.nii.gz,127,139,94,93,158,117,174,66,136,65,57,70
01332-000,../../DataSet/ASNR-MICCAI-BraTS2023-GLI-Challenge-TrainingData/BraTS-GLI-01332-000/BraTS-GLI-01332-000-t1c.nii.gz,../../DataSet/ASNR-MICCAI-BraTS2023-GLI-Challenge-TrainingData/BraTS-GLI-01332-000/BraTS-GLI-01332-000-t2w.nii.gz,../../DataSet/ASNR-MICCAI-BraTS2023-GLI-Challenge-TrainingData/BraTS-GLI-01332-000/BraTS-GLI-01332-000-t2f.nii.gz,../../DataSet/ASNR-MICCAI-BraTS2023-GLI-Challenge-TrainingData/BraTS-GLI-01332-000/BraTS-GLI-01332-000-t1n.nii.gz,../../DataSet/ASNR-MICCAI-BraTS2023-GLI-Challenge-TrainingData/BraTS-GLI-01332-000/BraTS-GLI-01332-000-seg.nii.gz,130,151,95,88,160,124,185,70,129,72,61,59
00572-000,../../DataSet/ASNR-MICCAI-BraTS2023-GLI-Challenge-TrainingData/BraTS-GLI-00572-000/BraTS-GLI-00572-000-t1c.nii.gz,../../DataSet/ASNR-MICCAI-BraTS2023-GLI-Challenge-TrainingData/BraTS-GLI-00572-000/BraTS-GLI-00572-000-t2w.nii.gz,../../DataSet/ASNR-MICCAI-BraTS2023-GLI-Challenge-TrainingData/BraTS-GLI-00572-000/BraTS-GLI-00572-000-t2f.nii.gz,../../DataSet/ASNR-MICCAI-BraTS2023-GLI-Challenge-TrainingData/BraTS-GLI-00572-000/BraTS-GLI-00572-000-t1n.nii.gz,../../DataSet/ASNR-MICCAI-BraTS2023-GLI-Challenge-TrainingData/BraTS-GLI-00572-000/BraTS-GLI-00572-000-seg.nii.gz,154,156,89,125,181,116,191,56,121,56,75,65
00113-000,../../DataSet/ASNR-MICCAI-BraTS2023-GLI-Challenge-TrainingData/BraTS-GLI-00113-000/BraTS-GLI-00113-000-t1c.nii.gz,../../DataSet/ASNR-MICCAI-BraTS2023-GLI-Challenge-TrainingData/BraTS-GLI-00113-000/BraTS-GLI-00113-000-t2w.nii.gz,../../DataSet/ASNR-MICCAI-BraTS2023-GLI-Challenge-TrainingData/BraTS-GLI-00113-000/BraTS-GLI-00113-000-t2f.nii.gz,../../DataSet/ASNR-MICCAI-BraTS2023-GLI-Challenge-TrainingData/BraTS-GLI-00113-000/BraTS-GLI-00113-000-t1n.nii.gz,../../DataSet/ASNR-MICCAI-BraTS2023-GLI-Challenge-TrainingData/BraTS-GLI-00113-000/BraTS-GLI-00113-000-seg.nii.gz,162,110,49,132,189,85,143,30,77,57,58,47
00736-001,../../DataSet/ASNR-MICCAI-BraTS2023-GLI-Challenge-TrainingData/BraTS-GLI-00736-001/BraTS-GLI-00736-001-t1c.nii.gz,../../DataSet/ASNR-MICCAI-BraTS2023-GLI-Challenge-TrainingData/BraTS-GLI-00736-001/BraTS-GLI-00736-001-t2w.nii.gz,../../DataSet/ASNR-MICCAI-BraTS2023-GLI-Challenge-TrainingData/BraTS-GLI-00736-001/BraTS-GLI-00736-001-t2f.nii.gz,../../DataSet/ASNR-MICCAI-BraTS2023-GLI-Challenge-TrainingData/BraTS-GLI-00736-001/BraTS-GLI-00736-001-t1n.nii.gz,../../DataSet/ASNR-MICCAI-BraTS2023-GLI-Challenge-TrainingData/BraTS-GLI-00736-001/BraTS-GLI-00736-001-seg.nii.gz,101,116,111,70,125,88,151,84,141,55,63,57
01216-000,../../DataSet/ASNR-MICCAI-BraTS2023-GLI-Challenge-TrainingData/BraTS-GLI-01216-000/BraTS-GLI-01216-000-t1c.nii.gz,../../DataSet/ASNR-MICCAI-BraTS2023-GLI-Challenge-TrainingData/BraTS-GLI-01216-000/BraTS-GLI-01216-000-t2w.nii.gz,../../DataSet/ASNR-MICCAI-BraTS2023-GLI-Challenge-TrainingData/BraTS-GLI-01216-000/BraTS-GLI-01216-000-t2f.nii.gz,../../DataSet/ASNR-MICCAI-BraTS2023-GLI-Challenge-TrainingData/BraTS-GLI-01216-000/BraTS-GLI-01216-000-t1n.nii.gz,../../DataSet/ASNR-MICCAI-BraTS2023-GLI-Challenge-TrainingData/BraTS-GLI-01216-000/BraTS-GLI-01216-000-seg.nii.gz,88,142,93,58,119,99,189,57,136,61,90,79
00456-000,../../DataSet/ASNR-MICCAI-BraTS2023-GLI-Challenge-TrainingData/BraTS-GLI-00456-000/BraTS-GLI-00456-000-t1c.nii.gz,../../DataSet/ASNR-MICCAI-BraTS2023-GLI-Challenge-TrainingData/BraTS-GLI-00456-000/BraTS-GLI-00456-000-t2w.nii.gz,../../DataSet/ASNR-MICCAI-BraTS2023-GLI-Challenge-TrainingData/BraTS-GLI-00456-000/BraTS-GLI-00456-000-t2f.nii.gz,../../DataSet/ASNR-MICCAI-BraTS2023-GLI-Challenge-TrainingData/BraTS-GLI-00456-000/BraTS-GLI-00456-000-t1n.nii.gz,../../DataSet/ASNR-MICCAI-BraTS2023-GLI-Challenge-TrainingData/BraTS-GLI-00456-000/BraTS-GLI-00456-000-seg.nii.gz,100,102,91,61,148,57,150,52,133,87,93,81
00824-000,../../DataSet/ASNR-MICCAI-BraTS2023-GLI-Challenge-TrainingData/BraTS-GLI-00824-000/BraTS-GLI-00824-000-t1c.nii.gz,../../DataSet/ASNR-MICCAI-BraTS2023-GLI-Challenge-TrainingData/BraTS-GLI-00824-000/BraTS-GLI-00824-000-t2w.nii.gz,../../DataSet/ASNR-MICCAI-BraTS2023-GLI-Challenge-TrainingData/BraTS-GLI-00824-000/BraTS-GLI-00824-000-t2f.nii.gz,../../DataSet/ASNR-MICCAI-BraTS2023-GLI-Challenge-TrainingData/BraTS-GLI-00824-000/BraTS-GLI-00824-000-t1n.nii.gz,../../DataSet/ASNR-MICCAI-BraTS2023-GLI-Challenge-TrainingData/BraTS-GLI-00824-000/BraTS-GLI-00824-000-seg.nii.gz,107,159,83,82,146,121,199,49,119,64,78,70
00612-001,../../DataSet/ASNR-MICCAI-BraTS2023-GLI-Challenge-TrainingData/BraTS-GLI-00612-001/BraTS-GLI-00612-001-t1c.nii.gz,../../DataSet/ASNR-MICCAI-BraTS2023-GLI-Challenge-TrainingData/BraTS-GLI-00612-001/BraTS-GLI-00612-001-t2w.nii.gz,../../DataSet/ASNR-MICCAI-BraTS2023-GLI-Challenge-TrainingData/BraTS-GLI-00612-001/BraTS-GLI-00612-001-t2f.nii.gz,../../DataSet/ASNR-MICCAI-BraTS2023-GLI-Challenge-TrainingData/BraTS-GLI-00612-001/BraTS-GLI-00612-001-t1n.nii.gz,../../DataSet/ASNR-MICCAI-BraTS2023-GLI-Challenge-TrainingData/BraTS-GLI-00612-001/BraTS-GLI-00612-001-seg.nii.gz,91,116,60,67,125,82,150,39,86,58,68,47
01101-000,../../DataSet/ASNR-MICCAI-BraTS2023-GLI-Challenge-TrainingData/BraTS-GLI-01101-000/BraTS-GLI-01101-000-t1c.nii.gz,../../DataSet/ASNR-MICCAI-BraTS2023-GLI-Challenge-TrainingData/BraTS-GLI-01101-000/BraTS-GLI-01101-000-t2w.nii.gz,../../DataSet/ASNR-MICCAI-BraTS2023-GLI-Challenge-TrainingData/BraTS-GLI-01101-000/BraTS-GLI-01101-000-t2f.nii.gz,../../DataSet/ASNR-MICCAI-BraTS2023-GLI-Challenge-TrainingData/BraTS-GLI-01101-000/BraTS-GLI-01101-000-t1n.nii.gz,../../DataSet/ASNR-MICCAI-BraTS2023-GLI-Challenge-TrainingData/BraTS-GLI-01101-000/BraTS-GLI-01101-000-seg.nii.gz,145,103,88,102,180,53,149,57,126,78,96,69
01059-000,../../DataSet/ASNR-MICCAI-BraTS2023-GLI-Challenge-TrainingData/BraTS-GLI-01059-000/BraTS-GLI-01059-000-t1c.nii.gz,../../DataSet/ASNR-MICCAI-BraTS2023-GLI-Challenge-TrainingData/BraTS-GLI-01059-000/BraTS-GLI-01059-000-t2w.nii.gz,../../DataSet/ASNR-MICCAI-BraTS2023-GLI-Challenge-TrainingData/BraTS-GLI-01059-000/BraTS-GLI-01059-000-t2f.nii.gz,../../DataSet/ASNR-MICCAI-BraTS2023-GLI-Challenge-TrainingData/BraTS-GLI-01059-000/BraTS-GLI-01059-000-t1n.nii.gz,../../DataSet/ASNR-MICCAI-BraTS2023-GLI-Challenge-TrainingData/BraTS-GLI-01059-000/BraTS-GLI-01059-000-seg.nii.gz,96,148,96,74,143,91,181,68,123,69,90,55
01438-000,../../DataSet/ASNR-MICCAI-BraTS2023-GLI-Challenge-TrainingData/BraTS-GLI-01438-000/BraTS-GLI-01438-000-t1c.nii.gz,../../DataSet/ASNR-MICCAI-BraTS2023-GLI-Challenge-TrainingData/BraTS-GLI-01438-000/BraTS-GLI-01438-000-t2w.nii.gz,../../DataSet/ASNR-MICCAI-BraTS2023-GLI-Challenge-TrainingData/BraTS-GLI-01438-000/BraTS-GLI-01438-000-t2f.nii.gz,../../DataSet/ASNR-MICCAI-BraTS2023-GLI-Challenge-TrainingData/BraTS-GLI-01438-000/BraTS-GLI-01438-000-t1n.nii.gz,../../DataSet/ASNR-MICCAI-BraTS2023-GLI-Challenge-TrainingData/BraTS-GLI-01438-000/BraTS-GLI-01438-000-seg.nii.gz,167,125,57,140,192,86,166,32,84,52,80,52
01088-000,../../DataSet/ASNR-MICCAI-BraTS2023-GLI-Challenge-TrainingData/BraTS-GLI-01088-000/BraTS-GLI-01088-000-t1c.nii.gz,../../DataSet/ASNR-MICCAI-BraTS2023-GLI-Challenge-TrainingData/BraTS-GLI-01088-000/BraTS-GLI-01088-000-t2w.nii.gz,../../DataSet/ASNR-MICCAI-BraTS2023-GLI-Challenge-TrainingData/BraTS-GLI-01088-000/BraTS-GLI-01088-000-t2f.nii.gz,../../DataSet/ASNR-MICCAI-BraTS2023-GLI-Challenge-TrainingData/BraTS-GLI-01088-000/BraTS-GLI-01088-000-t1n.nii.gz,../../DataSet/ASNR-MICCAI-BraTS2023-GLI-Challenge-TrainingData/BraTS-GLI-01088-000/BraTS-GLI-01088-000-seg.nii.gz,158,132,103,143,176,119,151,85,125,33,32,40
00823-000,../../DataSet/ASNR-MICCAI-BraTS2023-GLI-Challenge-TrainingData/BraTS-GLI-00823-000/BraTS-GLI-00823-000-t1c.nii.gz,../../DataSet/ASNR-MICCAI-BraTS2023-GLI-Challenge-TrainingData/BraTS-GLI-00823-000/BraTS-GLI-00823-000-t2w.nii.gz,../../DataSet/ASNR-MICCAI-BraTS2023-GLI-Challenge-TrainingData/BraTS-GLI-00823-000/BraTS-GLI-00823-000-t2f.nii.gz,../../DataSet/ASNR-MICCAI-BraTS2023-GLI-Challenge-TrainingData/BraTS-GLI-00823-000/BraTS-GLI-00823-000-t1n.nii.gz,../../DataSet/ASNR-MICCAI-BraTS2023-GLI-Challenge-TrainingData/BraTS-GLI-00823-000/BraTS-GLI-00823-000-seg.nii.gz,78,146,86,50,106,114,180,56,120,56,66,64
00451-000,../../DataSet/ASNR-MICCAI-BraTS2023-GLI-Challenge-TrainingData/BraTS-GLI-00451-000/BraTS-GLI-00451-000-t1c.nii.gz,../../DataSet/ASNR-MICCAI-BraTS2023-GLI-Challenge-TrainingData/BraTS-GLI-00451-000/BraTS-GLI-00451-000-t2w.nii.gz,../../DataSet/ASNR-MICCAI-BraTS2023-GLI-Challenge-TrainingData/BraTS-GLI-00451-000/BraTS-GLI-00451-000-t2f.nii.gz,../../DataSet/ASNR-MICCAI-BraTS2023-GLI-Challenge-TrainingData/BraTS-GLI-00451-000/BraTS-GLI-00451-000-t1n.nii.gz,../../DataSet/ASNR-MICCAI-BraTS2023-GLI-Challenge-TrainingData/BraTS-GLI-00451-000/BraTS-GLI-00451-000-seg.nii.gz,92,107,95,60,129,61,151,67,131,69,90,64
01211-000,../../DataSet/ASNR-MICCAI-BraTS2023-GLI-Challenge-TrainingData/BraTS-GLI-01211-000/BraTS-GLI-01211-000-t1c.nii.gz,../../DataSet/ASNR-MICCAI-BraTS2023-GLI-Challenge-TrainingData/BraTS-GLI-01211-000/BraTS-GLI-01211-000-t2w.nii.gz,../../DataSet/ASNR-MICCAI-BraTS2023-GLI-Challenge-TrainingData/BraTS-GLI-01211-000/BraTS-GLI-01211-000-t2f.nii.gz,../../DataSet/ASNR-MICCAI-BraTS2023-GLI-Challenge-TrainingData/BraTS-GLI-01211-000/BraTS-GLI-01211-000-t1n.nii.gz,../../DataSet/ASNR-MICCAI-BraTS2023-GLI-Challenge-TrainingData/BraTS-GLI-01211-000/BraTS-GLI-01211-000-seg.nii.gz,160,154,81,133,192,116,184,43,115,59,68,72
00030-000,../../DataSet/ASNR-MICCAI-BraTS2023-GLI-Challenge-TrainingData/BraTS-GLI-00030-000/BraTS-GLI-00030-000-t1c.nii.gz,../../DataSet/ASNR-MICCAI-BraTS2023-GLI-Challenge-TrainingData/BraTS-GLI-00030-000/BraTS-GLI-00030-000-t2w.nii.gz,../../DataSet/ASNR-MICCAI-BraTS2023-GLI-Challenge-TrainingData/BraTS-GLI-00030-000/BraTS-GLI-00030-000-t2f.nii.gz,../../DataSet/ASNR-MICCAI-BraTS2023-GLI-Challenge-TrainingData/BraTS-GLI-00030-000/BraTS-GLI-00030-000-t1n.nii.gz,../../DataSet/ASNR-MICCAI-BraTS2023-GLI-Challenge-TrainingData/BraTS-GLI-00030-000/BraTS-GLI-00030-000-seg.nii.gz,97,163,96,58,126,134,199,56,132,68,65,76
00746-000,../../DataSet/ASNR-MICCAI-BraTS2023-GLI-Challenge-TrainingData/BraTS-GLI-00746-000/BraTS-GLI-00746-000-t1c.nii.gz,../../DataSet/ASNR-MICCAI-BraTS2023-GLI-Challenge-TrainingData/BraTS-GLI-00746-000/BraTS-GLI-00746-000-t2w.nii.gz,../../DataSet/ASNR-MICCAI-BraTS2023-GLI-Challenge-TrainingData/BraTS-GLI-00746-000/BraTS-GLI-00746-000-t2f.nii.gz,../../DataSet/ASNR-MICCAI-BraTS2023-GLI-Challenge-TrainingData/BraTS-GLI-00746-000/BraTS-GLI-00746-000-t1n.nii.gz,../../DataSet/ASNR-MICCAI-BraTS2023-GLI-Challenge-TrainingData/BraTS-GLI-00746-000/BraTS-GLI-00746-000-seg.nii.gz,94,142,117,79,115,125,162,96,135,36,37,39
01106-000,../../DataSet/ASNR-MICCAI-BraTS2023-GLI-Challenge-TrainingData/BraTS-GLI-01106-000/BraTS-GLI-01106-000-t1c.nii.gz,../../DataSet/ASNR-MICCAI-BraTS2023-GLI-Challenge-TrainingData/BraTS-GLI-01106-000/BraTS-GLI-01106-000-t2w.nii.gz,../../DataSet/ASNR-MICCAI-BraTS2023-GLI-Challenge-TrainingData/BraTS-GLI-01106-000/BraTS-GLI-01106-000-t2f.nii.gz,../../DataSet/ASNR-MICCAI-BraTS2023-GLI-Challenge-TrainingData/BraTS-GLI-01106-000/BraTS-GLI-01106-000-t1n.nii.gz,../../DataSet/ASNR-MICCAI-BraTS2023-GLI-Challenge-TrainingData/BraTS-GLI-01106-000/BraTS-GLI-01106-000-seg.nii.gz,159,151,95,120,186,118,194,42,127,66,76,85
00480-000,../../DataSet/ASNR-MICCAI-BraTS2023-GLI-Challenge-TrainingData/BraTS-GLI-00480-000/BraTS-GLI-00480-000-t1c.nii.gz,../../DataSet/ASNR-MICCAI-BraTS2023-GLI-Challenge-TrainingData/BraTS-GLI-00480-000/BraTS-GLI-00480-000-t2w.nii.gz,../../DataSet/ASNR-MICCAI-BraTS2023-GLI-Challenge-TrainingData/BraTS-GLI-00480-000/BraTS-GLI-00480-000-t2f.nii.gz,../../DataSet/ASNR-MICCAI-BraTS2023-GLI-Challenge-TrainingData/BraTS-GLI-00480-000/BraTS-GLI-00480-000-t1n.nii.gz,../../DataSet/ASNR-MICCAI-BraTS2023-GLI-Challenge-TrainingData/BraTS-GLI-00480-000/BraTS-GLI-00480-000-seg.nii.gz,134,164,79,108,162,132,201,51,123,54,69,72
01398-000,../../DataSet/ASNR-MICCAI-BraTS2023-GLI-Challenge-TrainingData/BraTS-GLI-01398-000/BraTS-GLI-01398-000-t1c.nii.gz,../../DataSet/ASNR-MICCAI-BraTS2023-GLI-Challenge-TrainingData/BraTS-GLI-01398-000/BraTS-GLI-01398-000-t2w.nii.gz,../../DataSet/ASNR-MICCAI-BraTS2023-GLI-Challenge-TrainingData/BraTS-GLI-01398-000/BraTS-GLI-01398-000-t2f.nii.gz,../../DataSet/ASNR-MICCAI-BraTS2023-GLI-Challenge-TrainingData/BraTS-GLI-01398-000/BraTS-GLI-01398-000-t1n.nii.gz,../../DataSet/ASNR-MICCAI-BraTS2023-GLI-Challenge-TrainingData/BraTS-GLI-01398-000/BraTS-GLI-01398-000-seg.nii.gz,108,80,92,89,129,57,104,67,120,40,47,53
01349-000,../../DataSet/ASNR-MICCAI-BraTS2023-GLI-Challenge-TrainingData/BraTS-GLI-01349-000/BraTS-GLI-01349-000-t1c.nii.gz,../../DataSet/ASNR-MICCAI-BraTS2023-GLI-Challenge-TrainingData/BraTS-GLI-01349-000/BraTS-GLI-01349-000-t2w.nii.gz,../../DataSet/ASNR-MICCAI-BraTS2023-GLI-Challenge-TrainingData/BraTS-GLI-01349-000/BraTS-GLI-01349-000-t2f.nii.gz,../../DataSet/ASNR-MICCAI-BraTS2023-GLI-Challenge-TrainingData/BraTS-GLI-01349-000/BraTS-GLI-01349-000-t1n.nii.gz,../../DataSet/ASNR-MICCAI-BraTS2023-GLI-Challenge-TrainingData/BraTS-GLI-01349-000/BraTS-GLI-01349-000-seg.nii.gz,81,124,89,63,109,88,172,74,126,46,84,52
01022-000,../../DataSet/ASNR-MICCAI-BraTS2023-GLI-Challenge-TrainingData/BraTS-GLI-01022-000/BraTS-GLI-01022-000-t1c.nii.gz,../../DataSet/ASNR-MICCAI-BraTS2023-GLI-Challenge-TrainingData/BraTS-GLI-01022-000/BraTS-GLI-01022-000-t2w.nii.gz,../../DataSet/ASNR-MICCAI-BraTS2023-GLI-Challenge-TrainingData/BraTS-GLI-01022-000/BraTS-GLI-01022-000-t2f.nii.gz,../../DataSet/ASNR-MICCAI-BraTS2023-GLI-Challenge-TrainingData/BraTS-GLI-01022-000/BraTS-GLI-01022-000-t1n.nii.gz,../../DataSet/ASNR-MICCAI-BraTS2023-GLI-Challenge-TrainingData/BraTS-GLI-01022-000/BraTS-GLI-01022-000-seg.nii.gz,82,129,67,53,114,84,180,30,108,61,96,78
01443-000,../../DataSet/ASNR-MICCAI-BraTS2023-GLI-Challenge-TrainingData/BraTS-GLI-01443-000/BraTS-GLI-01443-000-t1c.nii.gz,../../DataSet/ASNR-MICCAI-BraTS2023-GLI-Challenge-TrainingData/BraTS-GLI-01443-000/BraTS-GLI-01443-000-t2w.nii.gz,../../DataSet/ASNR-MICCAI-BraTS2023-GLI-Challenge-TrainingData/BraTS-GLI-01443-000/BraTS-GLI-01443-000-t2f.nii.gz,../../DataSet/ASNR-MICCAI-BraTS2023-GLI-Challenge-TrainingData/BraTS-GLI-01443-000/BraTS-GLI-01443-000-t1n.nii.gz,../../DataSet/ASNR-MICCAI-BraTS2023-GLI-Challenge-TrainingData/BraTS-GLI-01443-000/BraTS-GLI-01443-000-seg.nii.gz,156,112,47,132,182,82,149,24,74,50,67,50
00203-000,../../DataSet/ASNR-MICCAI-BraTS2023-GLI-Challenge-TrainingData/BraTS-GLI-00203-000/BraTS-GLI-00203-000-t1c.nii.gz,../../DataSet/ASNR-MICCAI-BraTS2023-GLI-Challenge-TrainingData/BraTS-GLI-00203-000/BraTS-GLI-00203-000-t2w.nii.gz,../../DataSet/ASNR-MICCAI-BraTS2023-GLI-Challenge-TrainingData/BraTS-GLI-00203-000/BraTS-GLI-00203-000-t2f.nii.gz,../../DataSet/ASNR-MICCAI-BraTS2023-GLI-Challenge-TrainingData/BraTS-GLI-00203-000/BraTS-GLI-00203-000-t1n.nii.gz,../../DataSet/ASNR-MICCAI-BraTS2023-GLI-Challenge-TrainingData/BraTS-GLI-00203-000/BraTS-GLI-00203-000-seg.nii.gz,149,120,69,116,175,84,171,35,108,59,87,73
00575-000,../../DataSet/ASNR-MICCAI-BraTS2023-GLI-Challenge-TrainingData/BraTS-GLI-00575-000/BraTS-GLI-00575-000-t1c.nii.gz,../../DataSet/ASNR-MICCAI-BraTS2023-GLI-Challenge-TrainingData/BraTS-GLI-00575-000/BraTS-GLI-00575-000-t2w.nii.gz,../../DataSet/ASNR-MICCAI-BraTS2023-GLI-Challenge-TrainingData/BraTS-GLI-00575-000/BraTS-GLI-00575-000-t2f.nii.gz,../../DataSet/ASNR-MICCAI-BraTS2023-GLI-Challenge-TrainingData/BraTS-GLI-00575-000/BraTS-GLI-00575-000-t1n.nii.gz,../../DataSet/ASNR-MICCAI-BraTS2023-GLI-Challenge-TrainingData/BraTS-GLI-00575-000/BraTS-GLI-00575-000-seg.nii.gz,154,122,74,123,185,79,171,42,108,62,92,66
01492-000,../../DataSet/ASNR-MICCAI-BraTS2023-GLI-Challenge-TrainingData/BraTS-GLI-01492-000/BraTS-GLI-01492-000-t1c.nii.gz,../../DataSet/ASNR-MICCAI-BraTS2023-GLI-Challenge-TrainingData/BraTS-GLI-01492-000/BraTS-GLI-01492-000-t2w.nii.gz,../../DataSet/ASNR-MICCAI-BraTS2023-GLI-Challenge-TrainingData/BraTS-GLI-01492-000/BraTS-GLI-01492-000-t2f.nii.gz,../../DataSet/ASNR-MICCAI-BraTS2023-GLI-Challenge-TrainingData/BraTS-GLI-01492-000/BraTS-GLI-01492-000-t1n.nii.gz,../../DataSet/ASNR-MICCAI-BraTS2023-GLI-Challenge-TrainingData/BraTS-GLI-01492-000/BraTS-GLI-01492-000-seg.nii.gz,77,148,99,57,149,120,181,40,127,92,61,87
01335-000,../../DataSet/ASNR-MICCAI-BraTS2023-GLI-Challenge-TrainingData/BraTS-GLI-01335-000/BraTS-GLI-01335-000-t1c.nii.gz,../../DataSet/ASNR-MICCAI-BraTS2023-GLI-Challenge-TrainingData/BraTS-GLI-01335-000/BraTS-GLI-01335-000-t2w.nii.gz,../../DataSet/ASNR-MICCAI-BraTS2023-GLI-Challenge-TrainingData/BraTS-GLI-01335-000/BraTS-GLI-01335-000-t2f.nii.gz,../../DataSet/ASNR-MICCAI-BraTS2023-GLI-Challenge-TrainingData/BraTS-GLI-01335-000/BraTS-GLI-01335-000-t1n.nii.gz,../../DataSet/ASNR-MICCAI-BraTS2023-GLI-Challenge-TrainingData/BraTS-GLI-01335-000/BraTS-GLI-01335-000-seg.nii.gz,157,146,88,129,187,106,192,50,132,58,86,82
00096-001,../../DataSet/ASNR-MICCAI-BraTS2023-GLI-Challenge-TrainingData/BraTS-GLI-00096-001/BraTS-GLI-00096-001-t1c.nii.gz,../../DataSet/ASNR-MICCAI-BraTS2023-GLI-Challenge-TrainingData/BraTS-GLI-00096-001/BraTS-GLI-00096-001-t2w.nii.gz,../../DataSet/ASNR-MICCAI-BraTS2023-GLI-Challenge-TrainingData/BraTS-GLI-00096-001/BraTS-GLI-00096-001-t2f.nii.gz,../../DataSet/ASNR-MICCAI-BraTS2023-GLI-Challenge-TrainingData/BraTS-GLI-00096-001/BraTS-GLI-00096-001-t1n.nii.gz,../../DataSet/ASNR-MICCAI-BraTS2023-GLI-Challenge-TrainingData/BraTS-GLI-00096-001/BraTS-GLI-00096-001-seg.nii.gz,76,148,67,50,104,106,186,41,103,54,80,62
00731-001,../../DataSet/ASNR-MICCAI-BraTS2023-GLI-Challenge-TrainingData/BraTS-GLI-00731-001/BraTS-GLI-00731-001-t1c.nii.gz,../../DataSet/ASNR-MICCAI-BraTS2023-GLI-Challenge-TrainingData/BraTS-GLI-00731-001/BraTS-GLI-00731-001-t2w.nii.gz,../../DataSet/ASNR-MICCAI-BraTS2023-GLI-Challenge-TrainingData/BraTS-GLI-00731-001/BraTS-GLI-00731-001-t2f.nii.gz,../../DataSet/ASNR-MICCAI-BraTS2023-GLI-Challenge-TrainingData/BraTS-GLI-00731-001/BraTS-GLI-00731-001-t1n.nii.gz,../../DataSet/ASNR-MICCAI-BraTS2023-GLI-Challenge-TrainingData/BraTS-GLI-00731-001/BraTS-GLI-00731-001-seg.nii.gz,71,125,57,54,118,67,156,11,99,64,89,88
00312-000,../../DataSet/ASNR-MICCAI-BraTS2023-GLI-Challenge-TrainingData/BraTS-GLI-00312-000/BraTS-GLI-00312-000-t1c.nii.gz,../../DataSet/ASNR-MICCAI-BraTS2023-GLI-Challenge-TrainingData/BraTS-GLI-00312-000/BraTS-GLI-00312-000-t2w.nii.gz,../../DataSet/ASNR-MICCAI-BraTS2023-GLI-Challenge-TrainingData/BraTS-GLI-00312-000/BraTS-GLI-00312-000-t2f.nii.gz,../../DataSet/ASNR-MICCAI-BraTS2023-GLI-Challenge-TrainingData/BraTS-GLI-00312-000/BraTS-GLI-00312-000-t1n.nii.gz,../../DataSet/ASNR-MICCAI-BraTS2023-GLI-Challenge-TrainingData/BraTS-GLI-00312-000/BraTS-GLI-00312-000-seg.nii.gz,148,163,74,110,177,115,208,44,109,67,93,65
00773-000,../../DataSet/ASNR-MICCAI-BraTS2023-GLI-Challenge-TrainingData/BraTS-GLI-00773-000/BraTS-GLI-00773-000-t1c.nii.gz,../../DataSet/ASNR-MICCAI-BraTS2023-GLI-Challenge-TrainingData/BraTS-GLI-00773-000/BraTS-GLI-00773-000-t2w.nii.gz,../../DataSet/ASNR-MICCAI-BraTS2023-GLI-Challenge-TrainingData/BraTS-GLI-00773-000/BraTS-GLI-00773-000-t2f.nii.gz,../../DataSet/ASNR-MICCAI-BraTS2023-GLI-Challenge-TrainingData/BraTS-GLI-00773-000/BraTS-GLI-00773-000-t1n.nii.gz,../../DataSet/ASNR-MICCAI-BraTS2023-GLI-Challenge-TrainingData/BraTS-GLI-00773-000/BraTS-GLI-00773-000-seg.nii.gz,94,93,92,59,147,48,132,59,129,88,84,70
01133-000,../../DataSet/ASNR-MICCAI-BraTS2023-GLI-Challenge-TrainingData/BraTS-GLI-01133-000/BraTS-GLI-01133-000-t1c.nii.gz,../../DataSet/ASNR-MICCAI-BraTS2023-GLI-Challenge-TrainingData/BraTS-GLI-01133-000/BraTS-GLI-01133-000-t2w.nii.gz,../../DataSet/ASNR-MICCAI-BraTS2023-GLI-Challenge-TrainingData/BraTS-GLI-01133-000/BraTS-GLI-01133-000-t2f.nii.gz,../../DataSet/ASNR-MICCAI-BraTS2023-GLI-Challenge-TrainingData/BraTS-GLI-01133-000/BraTS-GLI-01133-000-t1n.nii.gz,../../DataSet/ASNR-MICCAI-BraTS2023-GLI-Challenge-TrainingData/BraTS-GLI-01133-000/BraTS-GLI-01133-000-seg.nii.gz,140,128,111,124,167,91,162,88,136,43,71,48
00005-000,../../DataSet/ASNR-MICCAI-BraTS2023-GLI-Challenge-TrainingData/BraTS-GLI-00005-000/BraTS-GLI-00005-000-t1c.nii.gz,../../DataSet/ASNR-MICCAI-BraTS2023-GLI-Challenge-TrainingData/BraTS-GLI-00005-000/BraTS-GLI-00005-000-t2w.nii.gz,../../DataSet/ASNR-MICCAI-BraTS2023-GLI-Challenge-TrainingData/BraTS-GLI-00005-000/BraTS-GLI-00005-000-t2f.nii.gz,../../DataSet/ASNR-MICCAI-BraTS2023-GLI-Challenge-TrainingData/BraTS-GLI-00005-000/BraTS-GLI-00005-000-t1n.nii.gz,../../DataSet/ASNR-MICCAI-BraTS2023-GLI-Challenge-TrainingData/BraTS-GLI-00005-000/BraTS-GLI-00005-000-seg.nii.gz,146,149,105,108,178,107,193,73,137,70,86,64
00464-000,../../DataSet/ASNR-MICCAI-BraTS2023-GLI-Challenge-TrainingData/BraTS-GLI-00464-000/BraTS-GLI-00464-000-t1c.nii.gz,../../DataSet/ASNR-MICCAI-BraTS2023-GLI-Challenge-TrainingData/BraTS-GLI-00464-000/BraTS-GLI-00464-000-t2w.nii.gz,../../DataSet/ASNR-MICCAI-BraTS2023-GLI-Challenge-TrainingData/BraTS-GLI-00464-000/BraTS-GLI-00464-000-t2f.nii.gz,../../DataSet/ASNR-MICCAI-BraTS2023-GLI-Challenge-TrainingData/BraTS-GLI-00464-000/BraTS-GLI-00464-000-t1n.nii.gz,../../DataSet/ASNR-MICCAI-BraTS2023-GLI-Challenge-TrainingData/BraTS-GLI-00464-000/BraTS-GLI-00464-000-seg.nii.gz,169,110,75,156,185,95,127,61,90,29,32,29
01224-000,../../DataSet/ASNR-MICCAI-BraTS2023-GLI-Challenge-TrainingData/BraTS-GLI-01224-000/BraTS-GLI-01224-000-t1c.nii.gz,../../DataSet/ASNR-MICCAI-BraTS2023-GLI-Challenge-TrainingData/BraTS-GLI-01224-000/BraTS-GLI-01224-000-t2w.nii.gz,../../DataSet/ASNR-MICCAI-BraTS2023-GLI-Challenge-TrainingData/BraTS-GLI-01224-000/BraTS-GLI-01224-000-t2f.nii.gz,../../DataSet/ASNR-MICCAI-BraTS2023-GLI-Challenge-TrainingData/BraTS-GLI-01224-000/BraTS-GLI-01224-000-t1n.nii.gz,../../DataSet/ASNR-MICCAI-BraTS2023-GLI-Challenge-TrainingData/BraTS-GLI-01224-000/BraTS-GLI-01224-000-seg.nii.gz,146,145,100,98,175,102,189,67,127,77,87,60
01289-000,../../DataSet/ASNR-MICCAI-BraTS2023-GLI-Challenge-TrainingData/BraTS-GLI-01289-000/BraTS-GLI-01289-000-t1c.nii.gz,../../DataSet/ASNR-MICCAI-BraTS2023-GLI-Challenge-TrainingData/BraTS-GLI-01289-000/BraTS-GLI-01289-000-t2w.nii.gz,../../DataSet/ASNR-MICCAI-BraTS2023-GLI-Challenge-TrainingData/BraTS-GLI-01289-000/BraTS-GLI-01289-000-t2f.nii.gz,../../DataSet/ASNR-MICCAI-BraTS2023-GLI-Challenge-TrainingData/BraTS-GLI-01289-000/BraTS-GLI-01289-000-t1n.nii.gz,../../DataSet/ASNR-MICCAI-BraTS2023-GLI-Challenge-TrainingData/BraTS-GLI-01289-000/BraTS-GLI-01289-000-seg.nii.gz,159,147,57,136,187,107,194,30,89,51,87,59
01258-000,../../DataSet/ASNR-MICCAI-BraTS2023-GLI-Challenge-TrainingData/BraTS-GLI-01258-000/BraTS-GLI-01258-000-t1c.nii.gz,../../DataSet/ASNR-MICCAI-BraTS2023-GLI-Challenge-TrainingData/BraTS-GLI-01258-000/BraTS-GLI-01258-000-t2w.nii.gz,../../DataSet/ASNR-MICCAI-BraTS2023-GLI-Challenge-TrainingData/BraTS-GLI-01258-000/BraTS-GLI-01258-000-t2f.nii.gz,../../DataSet/ASNR-MICCAI-BraTS2023-GLI-Challenge-TrainingData/BraTS-GLI-01258-000/BraTS-GLI-01258-000-t1n.nii.gz,../../DataSet/ASNR-MICCAI-BraTS2023-GLI-Challenge-TrainingData/BraTS-GLI-01258-000/BraTS-GLI-01258-000-seg.nii.gz,86,125,96,55,117,93,160,48,136,62,67,88
00121-000,../../DataSet/ASNR-MICCAI-BraTS2023-GLI-Challenge-TrainingData/BraTS-GLI-00121-000/BraTS-GLI-00121-000-t1c.nii.gz,../../DataSet/ASNR-MICCAI-BraTS2023-GLI-Challenge-TrainingData/BraTS-GLI-00121-000/BraTS-GLI-00121-000-t2w.nii.gz,../../DataSet/ASNR-MICCAI-BraTS2023-GLI-Challenge-TrainingData/BraTS-GLI-00121-000/BraTS-GLI-00121-000-t2f.nii.gz,../../DataSet/ASNR-MICCAI-BraTS2023-GLI-Challenge-TrainingData/BraTS-GLI-00121-000/BraTS-GLI-00121-000-t1n.nii.gz,../../DataSet/ASNR-MICCAI-BraTS2023-GLI-Challenge-TrainingData/BraTS-GLI-00121-000/BraTS-GLI-00121-000-seg.nii.gz,141,179,79,120,169,138,209,39,123,49,71,84
01300-000,../../DataSet/ASNR-MICCAI-BraTS2023-GLI-Challenge-TrainingData/BraTS-GLI-01300-000/BraTS-GLI-01300-000-t1c.nii.gz,../../DataSet/ASNR-MICCAI-BraTS2023-GLI-Challenge-TrainingData/BraTS-GLI-01300-000/BraTS-GLI-01300-000-t2w.nii.gz,../../DataSet/ASNR-MICCAI-BraTS2023-GLI-Challenge-TrainingData/BraTS-GLI-01300-000/BraTS-GLI-01300-000-t2f.nii.gz,../../DataSet/ASNR-MICCAI-BraTS2023-GLI-Challenge-TrainingData/BraTS-GLI-01300-000/BraTS-GLI-01300-000-t1n.nii.gz,../../DataSet/ASNR-MICCAI-BraTS2023-GLI-Challenge-TrainingData/BraTS-GLI-01300-000/BraTS-GLI-01300-000-seg.nii.gz,159,123,70,130,181,93,156,43,101,51,63,58
01476-000,../../DataSet/ASNR-MICCAI-BraTS2023-GLI-Challenge-TrainingData/BraTS-GLI-01476-000/BraTS-GLI-01476-000-t1c.nii.gz,../../DataSet/ASNR-MICCAI-BraTS2023-GLI-Challenge-TrainingData/BraTS-GLI-01476-000/BraTS-GLI-01476-000-t2w.nii.gz,../../DataSet/ASNR-MICCAI-BraTS2023-GLI-Challenge-TrainingData/BraTS-GLI-01476-000/BraTS-GLI-01476-000-t2f.nii.gz,../../DataSet/ASNR-MICCAI-BraTS2023-GLI-Challenge-TrainingData/BraTS-GLI-01476-000/BraTS-GLI-01476-000-t1n.nii.gz,../../DataSet/ASNR-MICCAI-BraTS2023-GLI-Challenge-TrainingData/BraTS-GLI-01476-000/BraTS-GLI-01476-000-seg.nii.gz,87,119,76,70,110,89,148,43,104,40,59,61
00591-000,../../DataSet/ASNR-MICCAI-BraTS2023-GLI-Challenge-TrainingData/BraTS-GLI-00591-000/BraTS-GLI-00591-000-t1c.nii.gz,../../DataSet/ASNR-MICCAI-BraTS2023-GLI-Challenge-TrainingData/BraTS-GLI-00591-000/BraTS-GLI-00591-000-t2w.nii.gz,../../DataSet/ASNR-MICCAI-BraTS2023-GLI-Challenge-TrainingData/BraTS-GLI-00591-000/BraTS-GLI-00591-000-t2f.nii.gz,../../DataSet/ASNR-MICCAI-BraTS2023-GLI-Challenge-TrainingData/BraTS-GLI-00591-000/BraTS-GLI-00591-000-t1n.nii.gz,../../DataSet/ASNR-MICCAI-BraTS2023-GLI-Challenge-TrainingData/BraTS-GLI-00591-000/BraTS-GLI-00591-000-seg.nii.gz,97,156,85,61,150,117,197,51,130,89,80,79
00236-000,../../DataSet/ASNR-MICCAI-BraTS2023-GLI-Challenge-TrainingData/BraTS-GLI-00236-000/BraTS-GLI-00236-000-t1c.nii.gz,../../DataSet/ASNR-MICCAI-BraTS2023-GLI-Challenge-TrainingData/BraTS-GLI-00236-000/BraTS-GLI-00236-000-t2w.nii.gz,../../DataSet/ASNR-MICCAI-BraTS2023-GLI-Challenge-TrainingData/BraTS-GLI-00236-000/BraTS-GLI-00236-000-t2f.nii.gz,../../DataSet/ASNR-MICCAI-BraTS2023-GLI-Challenge-TrainingData/BraTS-GLI-00236-000/BraTS-GLI-00236-000-t1n.nii.gz,../../DataSet/ASNR-MICCAI-BraTS2023-GLI-Challenge-TrainingData/BraTS-GLI-00236-000/BraTS-GLI-00236-000-seg.nii.gz,89,106,91,65,140,72,150,59,124,75,78,65
00657-000,../../DataSet/ASNR-MICCAI-BraTS2023-GLI-Challenge-TrainingData/BraTS-GLI-00657-000/BraTS-GLI-00657-000-t1c.nii.gz,../../DataSet/ASNR-MICCAI-BraTS2023-GLI-Challenge-TrainingData/BraTS-GLI-00657-000/BraTS-GLI-00657-000-t2w.nii.gz,../../DataSet/ASNR-MICCAI-BraTS2023-GLI-Challenge-TrainingData/BraTS-GLI-00657-000/BraTS-GLI-00657-000-t2f.nii.gz,../../DataSet/ASNR-MICCAI-BraTS2023-GLI-Challenge-TrainingData/BraTS-GLI-00657-000/BraTS-GLI-00657-000-t1n.nii.gz,../../DataSet/ASNR-MICCAI-BraTS2023-GLI-Challenge-TrainingData/BraTS-GLI-00657-000/BraTS-GLI-00657-000-seg.nii.gz,138,87,86,97,185,40,134,45,131,88,94,86
00072-001,../../DataSet/ASNR-MICCAI-BraTS2023-GLI-Challenge-TrainingData/BraTS-GLI-00072-001/BraTS-GLI-00072-001-t1c.nii.gz,../../DataSet/ASNR-MICCAI-BraTS2023-GLI-Challenge-TrainingData/BraTS-GLI-00072-001/BraTS-GLI-00072-001-t2w.nii.gz,../../DataSet/ASNR-MICCAI-BraTS2023-GLI-Challenge-TrainingData/BraTS-GLI-00072-001/BraTS-GLI-00072-001-t2f.nii.gz,../../DataSet/ASNR-MICCAI-BraTS2023-GLI-Challenge-TrainingData/BraTS-GLI-00072-001/BraTS-GLI-00072-001-t1n.nii.gz,../../DataSet/ASNR-MICCAI-BraTS2023-GLI-Challenge-TrainingData/BraTS-GLI-00072-001/BraTS-GLI-00072-001-seg.nii.gz,159,142,69,140,182,117,168,53,88,42,51,35
01017-000,../../DataSet/ASNR-MICCAI-BraTS2023-GLI-Challenge-TrainingData/BraTS-GLI-01017-000/BraTS-GLI-01017-000-t1c.nii.gz,../../DataSet/ASNR-MICCAI-BraTS2023-GLI-Challenge-TrainingData/BraTS-GLI-01017-000/BraTS-GLI-01017-000-t2w.nii.gz,../../DataSet/ASNR-MICCAI-BraTS2023-GLI-Challenge-TrainingData/BraTS-GLI-01017-000/BraTS-GLI-01017-000-t2f.nii.gz,../../DataSet/ASNR-MICCAI-BraTS2023-GLI-Challenge-TrainingData/BraTS-GLI-01017-000/BraTS-GLI-01017-000-t1n.nii.gz,../../DataSet/ASNR-MICCAI-BraTS2023-GLI-Challenge-TrainingData/BraTS-GLI-01017-000/BraTS-GLI-01017-000-seg.nii.gz,101,94,103,72,125,51,142,69,136,53,91,67
01529-000,../../DataSet/ASNR-MICCAI-BraTS2023-GLI-Challenge-TrainingData/BraTS-GLI-01529-000/BraTS-GLI-01529-000-t1c.nii.gz,../../DataSet/ASNR-MICCAI-BraTS2023-GLI-Challenge-TrainingData/BraTS-GLI-01529-000/BraTS-GLI-01529-000-t2w.nii.gz,../../DataSet/ASNR-MICCAI-BraTS2023-GLI-Challenge-TrainingData/BraTS-GLI-01529-000/BraTS-GLI-01529-000-t2f.nii.gz,../../DataSet/ASNR-MICCAI-BraTS2023-GLI-Challenge-TrainingData/BraTS-GLI-01529-000/BraTS-GLI-01529-000-t1n.nii.gz,../../DataSet/ASNR-MICCAI-BraTS2023-GLI-Challenge-TrainingData/BraTS-GLI-01529-000/BraTS-GLI-01529-000-seg.nii.gz,92,94,63,67,122,64,129,27,92,55,65,65
01148-000,../../DataSet/ASNR-MICCAI-BraTS2023-GLI-Challenge-TrainingData/BraTS-GLI-01148-000/BraTS-GLI-01148-000-t1c.nii.gz,../../DataSet/ASNR-MICCAI-BraTS2023-GLI-Challenge-TrainingData/BraTS-GLI-01148-000/BraTS-GLI-01148-000-t2w.nii.gz,../../DataSet/ASNR-MICCAI-BraTS2023-GLI-Challenge-TrainingData/BraTS-GLI-01148-000/BraTS-GLI-01148-000-t2f.nii.gz,../../DataSet/ASNR-MICCAI-BraTS2023-GLI-Challenge-TrainingData/BraTS-GLI-01148-000/BraTS-GLI-01148-000-t1n.nii.gz,../../DataSet/ASNR-MICCAI-BraTS2023-GLI-Challenge-TrainingData/BraTS-GLI-01148-000/BraTS-GLI-01148-000-seg.nii.gz,82,143,76,58,112,100,184,44,117,54,84,73
00708-000,../../DataSet/ASNR-MICCAI-BraTS2023-GLI-Challenge-TrainingData/BraTS-GLI-00708-000/BraTS-GLI-00708-000-t1c.nii.gz,../../DataSet/ASNR-MICCAI-BraTS2023-GLI-Challenge-TrainingData/BraTS-GLI-00708-000/BraTS-GLI-00708-000-t2w.nii.gz,../../DataSet/ASNR-MICCAI-BraTS2023-GLI-Challenge-TrainingData/BraTS-GLI-00708-000/BraTS-GLI-00708-000-t2f.nii.gz,../../DataSet/ASNR-MICCAI-BraTS2023-GLI-Challenge-TrainingData/BraTS-GLI-00708-000/BraTS-GLI-00708-000-t1n.nii.gz,../../DataSet/ASNR-MICCAI-BraTS2023-GLI-Challenge-TrainingData/BraTS-GLI-00708-000/BraTS-GLI-00708-000-seg.nii.gz,148,160,111,134,165,142,181,88,133,31,39,45
00126-000,../../DataSet/ASNR-MICCAI-BraTS2023-GLI-Challenge-TrainingData/BraTS-GLI-00126-000/BraTS-GLI-00126-000-t1c.nii.gz,../../DataSet/ASNR-MICCAI-BraTS2023-GLI-Challenge-TrainingData/BraTS-GLI-00126-000/BraTS-GLI-00126-000-t2w.nii.gz,../../DataSet/ASNR-MICCAI-BraTS2023-GLI-Challenge-TrainingData/BraTS-GLI-00126-000/BraTS-GLI-00126-000-t2f.nii.gz,../../DataSet/ASNR-MICCAI-BraTS2023-GLI-Challenge-TrainingData/BraTS-GLI-00126-000/BraTS-GLI-00126-000-t1n.nii.gz,../../DataSet/ASNR-MICCAI-BraTS2023-GLI-Challenge-TrainingData/BraTS-GLI-00126-000/BraTS-GLI-00126-000-seg.nii.gz,87,155,87,57,125,114,197,48,128,68,83,80
01307-000,../../DataSet/ASNR-MICCAI-BraTS2023-GLI-Challenge-TrainingData/BraTS-GLI-01307-000/BraTS-GLI-01307-000-t1c.nii.gz,../../DataSet/ASNR-MICCAI-BraTS2023-GLI-Challenge-TrainingData/BraTS-GLI-01307-000/BraTS-GLI-01307-000-t2w.nii.gz,../../DataSet/ASNR-MICCAI-BraTS2023-GLI-Challenge-TrainingData/BraTS-GLI-01307-000/BraTS-GLI-01307-000-t2f.nii.gz,../../DataSet/ASNR-MICCAI-BraTS2023-GLI-Challenge-TrainingData/BraTS-GLI-01307-000/BraTS-GLI-01307-000-t1n.nii.gz,../../DataSet/ASNR-MICCAI-BraTS2023-GLI-Challenge-TrainingData/BraTS-GLI-01307-000/BraTS-GLI-01307-000-seg.nii.gz,138,91,87,99,173,46,133,50,133,74,87,83
00547-000,../../DataSet/ASNR-MICCAI-BraTS2023-GLI-Challenge-TrainingData/BraTS-GLI-00547-000/BraTS-GLI-00547-000-t1c.nii.gz,../../DataSet/ASNR-MICCAI-BraTS2023-GLI-Challenge-TrainingData/BraTS-GLI-00547-000/BraTS-GLI-00547-000-t2w.nii.gz,../../DataSet/ASNR-MICCAI-BraTS2023-GLI-Challenge-TrainingData/BraTS-GLI-00547-000/BraTS-GLI-00547-000-t2f.nii.gz,../../DataSet/ASNR-MICCAI-BraTS2023-GLI-Challenge-TrainingData/BraTS-GLI-00547-000/BraTS-GLI-00547-000-t1n.nii.gz,../../DataSet/ASNR-MICCAI-BraTS2023-GLI-Challenge-TrainingData/BraTS-GLI-00547-000/BraTS-GLI-00547-000-seg.nii.gz,149,105,107,128,172,66,136,83,133,44,70,50
00231-000,../../DataSet/ASNR-MICCAI-BraTS2023-GLI-Challenge-TrainingData/BraTS-GLI-00231-000/BraTS-GLI-00231-000-t1c.nii.gz,../../DataSet/ASNR-MICCAI-BraTS2023-GLI-Challenge-TrainingData/BraTS-GLI-00231-000/BraTS-GLI-00231-000-t2w.nii.gz,../../DataSet/ASNR-MICCAI-BraTS2023-GLI-Challenge-TrainingData/BraTS-GLI-00231-000/BraTS-GLI-00231-000-t2f.nii.gz,../../DataSet/ASNR-MICCAI-BraTS2023-GLI-Challenge-TrainingData/BraTS-GLI-00231-000/BraTS-GLI-00231-000-t1n.nii.gz,../../DataSet/ASNR-MICCAI-BraTS2023-GLI-Challenge-TrainingData/BraTS-GLI-00231-000/BraTS-GLI-00231-000-seg.nii.gz,161,146,87,134,189,104,179,64,117,55,75,53
00596-000,../../DataSet/ASNR-MICCAI-BraTS2023-GLI-Challenge-TrainingData/BraTS-GLI-00596-000/BraTS-GLI-00596-000-t1c.nii.gz,../../DataSet/ASNR-MICCAI-BraTS2023-GLI-Challenge-TrainingData/BraTS-GLI-00596-000/BraTS-GLI-00596-000-t2w.nii.gz,../../DataSet/ASNR-MICCAI-BraTS2023-GLI-Challenge-TrainingData/BraTS-GLI-00596-000/BraTS-GLI-00596-000-t2f.nii.gz,../../DataSet/ASNR-MICCAI-BraTS2023-GLI-Challenge-TrainingData/BraTS-GLI-00596-000/BraTS-GLI-00596-000-t1n.nii.gz,../../DataSet/ASNR-MICCAI-BraTS2023-GLI-Challenge-TrainingData/BraTS-GLI-00596-000/BraTS-GLI-00596-000-seg.nii.gz,102,148,98,74,141,112,206,56,130,67,94,74
01010-000,../../DataSet/ASNR-MICCAI-BraTS2023-GLI-Challenge-TrainingData/BraTS-GLI-01010-000/BraTS-GLI-01010-000-t1c.nii.gz,../../DataSet/ASNR-MICCAI-BraTS2023-GLI-Challenge-TrainingData/BraTS-GLI-01010-000/BraTS-GLI-01010-000-t2w.nii.gz,../../DataSet/ASNR-MICCAI-BraTS2023-GLI-Challenge-TrainingData/BraTS-GLI-01010-000/BraTS-GLI-01010-000-t2f.nii.gz,../../DataSet/ASNR-MICCAI-BraTS2023-GLI-Challenge-TrainingData/BraTS-GLI-01010-000/BraTS-GLI-01010-000-t1n.nii.gz,../../DataSet/ASNR-MICCAI-BraTS2023-GLI-Challenge-TrainingData/BraTS-GLI-01010-000/BraTS-GLI-01010-000-seg.nii.gz,157,145,52,133,185,100,188,32,86,52,88,54
00650-000,../../DataSet/ASNR-MICCAI-BraTS2023-GLI-Challenge-TrainingData/BraTS-GLI-00650-000/BraTS-GLI-00650-000-t1c.nii.gz,../../DataSet/ASNR-MICCAI-BraTS2023-GLI-Challenge-TrainingData/BraTS-GLI-00650-000/BraTS-GLI-00650-000-t2w.nii.gz,../../DataSet/ASNR-MICCAI-BraTS2023-GLI-Challenge-TrainingData/BraTS-GLI-00650-000/BraTS-GLI-00650-000-t2f.nii.gz,../../DataSet/ASNR-MICCAI-BraTS2023-GLI-Challenge-TrainingData/BraTS-GLI-00650-000/BraTS-GLI-00650-000-t1n.nii.gz,../../DataSet/ASNR-MICCAI-BraTS2023-GLI-Challenge-TrainingData/BraTS-GLI-00650-000/BraTS-GLI-00650-000-seg.nii.gz,142,120,115,120,175,79,166,78,144,55,87,66
01134-000,../../DataSet/ASNR-MICCAI-BraTS2023-GLI-Challenge-TrainingData/BraTS-GLI-01134-000/BraTS-GLI-01134-000-t1c.nii.gz,../../DataSet/ASNR-MICCAI-BraTS2023-GLI-Challenge-TrainingData/BraTS-GLI-01134-000/BraTS-GLI-01134-000-t2w.nii.gz,../../DataSet/ASNR-MICCAI-BraTS2023-GLI-Challenge-TrainingData/BraTS-GLI-01134-000/BraTS-GLI-01134-000-t2f.nii.gz,../../DataSet/ASNR-MICCAI-BraTS2023-GLI-Challenge-TrainingData/BraTS-GLI-01134-000/BraTS-GLI-01134-000-t1n.nii.gz,../../DataSet/ASNR-MICCAI-BraTS2023-GLI-Challenge-TrainingData/BraTS-GLI-01134-000/BraTS-GLI-01134-000-seg.nii.gz,91,130,85,68,117,90,171,55,119,49,81,64
00774-000,../../DataSet/ASNR-MICCAI-BraTS2023-GLI-Challenge-TrainingData/BraTS-GLI-00774-000/BraTS-GLI-00774-000-t1c.nii.gz,../../DataSet/ASNR-MICCAI-BraTS2023-GLI-Challenge-TrainingData/BraTS-GLI-00774-000/BraTS-GLI-00774-000-t2w.nii.gz,../../DataSet/ASNR-MICCAI-BraTS2023-GLI-Challenge-TrainingData/BraTS-GLI-00774-000/BraTS-GLI-00774-000-t2f.nii.gz,../../DataSet/ASNR-MICCAI-BraTS2023-GLI-Challenge-TrainingData/BraTS-GLI-00774-000/BraTS-GLI-00774-000-t1n.nii.gz,../../DataSet/ASNR-MICCAI-BraTS2023-GLI-Challenge-TrainingData/BraTS-GLI-00774-000/BraTS-GLI-00774-000-seg.nii.gz,99,162,87,65,148,127,207,52,130,83,80,78
01223-000,../../DataSet/ASNR-MICCAI-BraTS2023-GLI-Challenge-TrainingData/BraTS-GLI-01223-000/BraTS-GLI-01223-000-t1c.nii.gz,../../DataSet/ASNR-MICCAI-BraTS2023-GLI-Challenge-TrainingData/BraTS-GLI-01223-000/BraTS-GLI-01223-000-t2w.nii.gz,../../DataSet/ASNR-MICCAI-BraTS2023-GLI-Challenge-TrainingData/BraTS-GLI-01223-000/BraTS-GLI-01223-000-t2f.nii.gz,../../DataSet/ASNR-MICCAI-BraTS2023-GLI-Challenge-TrainingData/BraTS-GLI-01223-000/BraTS-GLI-01223-000-t1n.nii.gz,../../DataSet/ASNR-MICCAI-BraTS2023-GLI-Challenge-TrainingData/BraTS-GLI-01223-000/BraTS-GLI-01223-000-seg.nii.gz,133,120,100,100,165,88,152,56,132,65,64,76
00009-001,../../DataSet/ASNR-MICCAI-BraTS2023-GLI-Challenge-TrainingData/BraTS-GLI-00009-001/BraTS-GLI-00009-001-t1c.nii.gz,../../DataSet/ASNR-MICCAI-BraTS2023-GLI-Challenge-TrainingData/BraTS-GLI-00009-001/BraTS-GLI-00009-001-t2w.nii.gz,../../DataSet/ASNR-MICCAI-BraTS2023-GLI-Challenge-TrainingData/BraTS-GLI-00009-001/BraTS-GLI-00009-001-t2f.nii.gz,../../DataSet/ASNR-MICCAI-BraTS2023-GLI-Challenge-TrainingData/BraTS-GLI-00009-001/BraTS-GLI-00009-001-t1n.nii.gz,../../DataSet/ASNR-MICCAI-BraTS2023-GLI-Challenge-TrainingData/BraTS-GLI-00009-001/BraTS-GLI-00009-001-seg.nii.gz,146,98,105,118,174,62,131,82,127,56,69,45
01527-000,../../DataSet/ASNR-MICCAI-BraTS2023-GLI-Challenge-TrainingData/BraTS-GLI-01527-000/BraTS-GLI-01527-000-t1c.nii.gz,../../DataSet/ASNR-MICCAI-BraTS2023-GLI-Challenge-TrainingData/BraTS-GLI-01527-000/BraTS-GLI-01527-000-t2w.nii.gz,../../DataSet/ASNR-MICCAI-BraTS2023-GLI-Challenge-TrainingData/BraTS-GLI-01527-000/BraTS-GLI-01527-000-t2f.nii.gz,../../DataSet/ASNR-MICCAI-BraTS2023-GLI-Challenge-TrainingData/BraTS-GLI-01527-000/BraTS-GLI-01527-000-t1n.nii.gz,../../DataSet/ASNR-MICCAI-BraTS2023-GLI-Challenge-TrainingData/BraTS-GLI-01527-000/BraTS-GLI-01527-000-seg.nii.gz,155,114,54,123,184,81,151,26,82,61,70,56
01146-000,../../DataSet/ASNR-MICCAI-BraTS2023-GLI-Challenge-TrainingData/BraTS-GLI-01146-000/BraTS-GLI-01146-000-t1c.nii.gz,../../DataSet/ASNR-MICCAI-BraTS2023-GLI-Challenge-TrainingData/BraTS-GLI-01146-000/BraTS-GLI-01146-000-t2w.nii.gz,../../DataSet/ASNR-MICCAI-BraTS2023-GLI-Challenge-TrainingData/BraTS-GLI-01146-000/BraTS-GLI-01146-000-t2f.nii.gz,../../DataSet/ASNR-MICCAI-BraTS2023-GLI-Challenge-TrainingData/BraTS-GLI-01146-000/BraTS-GLI-01146-000-t1n.nii.gz,../../DataSet/ASNR-MICCAI-BraTS2023-GLI-Challenge-TrainingData/BraTS-GLI-01146-000/BraTS-GLI-01146-000-seg.nii.gz,99,98,98,67,130,58,133,66,133,63,75,67
01197-000,../../DataSet/ASNR-MICCAI-BraTS2023-GLI-Challenge-TrainingData/BraTS-GLI-01197-000/BraTS-GLI-01197-000-t1c.nii.gz,../../DataSet/ASNR-MICCAI-BraTS2023-GLI-Challenge-TrainingData/BraTS-GLI-01197-000/BraTS-GLI-01197-000-t2w.nii.gz,../../DataSet/ASNR-MICCAI-BraTS2023-GLI-Challenge-TrainingData/BraTS-GLI-01197-000/BraTS-GLI-01197-000-t2f.nii.gz,../../DataSet/ASNR-MICCAI-BraTS2023-GLI-Challenge-TrainingData/BraTS-GLI-01197-000/BraTS-GLI-01197-000-t1n.nii.gz,../../DataSet/ASNR-MICCAI-BraTS2023-GLI-Challenge-TrainingData/BraTS-GLI-01197-000/BraTS-GLI-01197-000-seg.nii.gz,148,155,87,120,180,116,196,52,126,60,80,74
00070-000,../../DataSet/ASNR-MICCAI-BraTS2023-GLI-Challenge-TrainingData/BraTS-GLI-00070-000/BraTS-GLI-00070-000-t1c.nii.gz,../../DataSet/ASNR-MICCAI-BraTS2023-GLI-Challenge-TrainingData/BraTS-GLI-00070-000/BraTS-GLI-00070-000-t2w.nii.gz,../../DataSet/ASNR-MICCAI-BraTS2023-GLI-Challenge-TrainingData/BraTS-GLI-00070-000/BraTS-GLI-00070-000-t2f.nii.gz,../../DataSet/ASNR-MICCAI-BraTS2023-GLI-Challenge-TrainingData/BraTS-GLI-00070-000/BraTS-GLI-00070-000-t1n.nii.gz,../../DataSet/ASNR-MICCAI-BraTS2023-GLI-Challenge-TrainingData/BraTS-GLI-00070-000/BraTS-GLI-00070-000-seg.nii.gz,146,96,99,112,180,46,138,69,137,68,92,68
01251-000,../../DataSet/ASNR-MICCAI-BraTS2023-GLI-Challenge-TrainingData/BraTS-GLI-01251-000/BraTS-GLI-01251-000-t1c.nii.gz,../../DataSet/ASNR-MICCAI-BraTS2023-GLI-Challenge-TrainingData/BraTS-GLI-01251-000/BraTS-GLI-01251-000-t2w.nii.gz,../../DataSet/ASNR-MICCAI-BraTS2023-GLI-Challenge-TrainingData/BraTS-GLI-01251-000/BraTS-GLI-01251-000-t2f.nii.gz,../../DataSet/ASNR-MICCAI-BraTS2023-GLI-Challenge-TrainingData/BraTS-GLI-01251-000/BraTS-GLI-01251-000-t1n.nii.gz,../../DataSet/ASNR-MICCAI-BraTS2023-GLI-Challenge-TrainingData/BraTS-GLI-01251-000/BraTS-GLI-01251-000-seg.nii.gz,99,108,98,66,146,64,156,62,143,80,92,81
00128-000,../../DataSet/ASNR-MICCAI-BraTS2023-GLI-Challenge-TrainingData/BraTS-GLI-00128-000/BraTS-GLI-00128-000-t1c.nii.gz,../../DataSet/ASNR-MICCAI-BraTS2023-GLI-Challenge-TrainingData/BraTS-GLI-00128-000/BraTS-GLI-00128-000-t2w.nii.gz,../../DataSet/ASNR-MICCAI-BraTS2023-GLI-Challenge-TrainingData/BraTS-GLI-00128-000/BraTS-GLI-00128-000-t2f.nii.gz,../../DataSet/ASNR-MICCAI-BraTS2023-GLI-Challenge-TrainingData/BraTS-GLI-00128-000/BraTS-GLI-00128-000-t1n.nii.gz,../../DataSet/ASNR-MICCAI-BraTS2023-GLI-Challenge-TrainingData/BraTS-GLI-00128-000/BraTS-GLI-00128-000-seg.nii.gz,84,154,86,58,111,112,200,55,124,53,88,69
00549-000,../../DataSet/ASNR-MICCAI-BraTS2023-GLI-Challenge-TrainingData/BraTS-GLI-00549-000/BraTS-GLI-00549-000-t1c.nii.gz,../../DataSet/ASNR-MICCAI-BraTS2023-GLI-Challenge-TrainingData/BraTS-GLI-00549-000/BraTS-GLI-00549-000-t2w.nii.gz,../../DataSet/ASNR-MICCAI-BraTS2023-GLI-Challenge-TrainingData/BraTS-GLI-00549-000/BraTS-GLI-00549-000-t2f.nii.gz,../../DataSet/ASNR-MICCAI-BraTS2023-GLI-Challenge-TrainingData/BraTS-GLI-00549-000/BraTS-GLI-00549-000-t1n.nii.gz,../../DataSet/ASNR-MICCAI-BraTS2023-GLI-Challenge-TrainingData/BraTS-GLI-00549-000/BraTS-GLI-00549-000-seg.nii.gz,101,85,101,68,130,43,123,72,142,62,80,70
00154-000,../../DataSet/ASNR-MICCAI-BraTS2023-GLI-Challenge-TrainingData/BraTS-GLI-00154-000/BraTS-GLI-00154-000-t1c.nii.gz,../../DataSet/ASNR-MICCAI-BraTS2023-GLI-Challenge-TrainingData/BraTS-GLI-00154-000/BraTS-GLI-00154-000-t2w.nii.gz,../../DataSet/ASNR-MICCAI-BraTS2023-GLI-Challenge-TrainingData/BraTS-GLI-00154-000/BraTS-GLI-00154-000-t2f.nii.gz,../../DataSet/ASNR-MICCAI-BraTS2023-GLI-Challenge-TrainingData/BraTS-GLI-00154-000/BraTS-GLI-00154-000-t1n.nii.gz,../../DataSet/ASNR-MICCAI-BraTS2023-GLI-Challenge-TrainingData/BraTS-GLI-00154-000/BraTS-GLI-00154-000-seg.nii.gz,85,172,61,50,117,133,211,26,108,67,78,82
00292-000,../../DataSet/ASNR-MICCAI-BraTS2023-GLI-Challenge-TrainingData/BraTS-GLI-00292-000/BraTS-GLI-00292-000-t1c.nii.gz,../../DataSet/ASNR-MICCAI-BraTS2023-GLI-Challenge-TrainingData/BraTS-GLI-00292-000/BraTS-GLI-00292-000-t2w.nii.gz,../../DataSet/ASNR-MICCAI-BraTS2023-GLI-Challenge-TrainingData/BraTS-GLI-00292-000/BraTS-GLI-00292-000-t2f.nii.gz,../../DataSet/ASNR-MICCAI-BraTS2023-GLI-Challenge-TrainingData/BraTS-GLI-00292-000/BraTS-GLI-00292-000-t1n.nii.gz,../../DataSet/ASNR-MICCAI-BraTS2023-GLI-Challenge-TrainingData/BraTS-GLI-00292-000/BraTS-GLI-00292-000-seg.nii.gz,87,112,56,57,122,83,159,27,82,65,76,55
01375-000,../../DataSet/ASNR-MICCAI-BraTS2023-GLI-Challenge-TrainingData/BraTS-GLI-01375-000/BraTS-GLI-01375-000-t1c.nii.gz,../../DataSet/ASNR-MICCAI-BraTS2023-GLI-Challenge-TrainingData/BraTS-GLI-01375-000/BraTS-GLI-01375-000-t2w.nii.gz,../../DataSet/ASNR-MICCAI-BraTS2023-GLI-Challenge-TrainingData/BraTS-GLI-01375-000/BraTS-GLI-01375-000-t2f.nii.gz,../../DataSet/ASNR-MICCAI-BraTS2023-GLI-Challenge-TrainingData/BraTS-GLI-01375-000/BraTS-GLI-01375-000-t1n.nii.gz,../../DataSet/ASNR-MICCAI-BraTS2023-GLI-Challenge-TrainingData/BraTS-GLI-01375-000/BraTS-GLI-01375-000-seg.nii.gz,121,159,82,88,151,122,193,54,112,63,71,58
01403-000,../../DataSet/ASNR-MICCAI-BraTS2023-GLI-Challenge-TrainingData/BraTS-GLI-01403-000/BraTS-GLI-01403-000-t1c.nii.gz,../../DataSet/ASNR-MICCAI-BraTS2023-GLI-Challenge-TrainingData/BraTS-GLI-01403-000/BraTS-GLI-01403-000-t2w.nii.gz,../../DataSet/ASNR-MICCAI-BraTS2023-GLI-Challenge-TrainingData/BraTS-GLI-01403-000/BraTS-GLI-01403-000-t2f.nii.gz,../../DataSet/ASNR-MICCAI-BraTS2023-GLI-Challenge-TrainingData/BraTS-GLI-01403-000/BraTS-GLI-01403-000-t1n.nii.gz,../../DataSet/ASNR-MICCAI-BraTS2023-GLI-Challenge-TrainingData/BraTS-GLI-01403-000/BraTS-GLI-01403-000-seg.nii.gz,133,86,88,93,174,48,137,56,125,81,89,69
00243-000,../../DataSet/ASNR-MICCAI-BraTS2023-GLI-Challenge-TrainingData/BraTS-GLI-00243-000/BraTS-GLI-00243-000-t1c.nii.gz,../../DataSet/ASNR-MICCAI-BraTS2023-GLI-Challenge-TrainingData/BraTS-GLI-00243-000/BraTS-GLI-00243-000-t2w.nii.gz,../../DataSet/ASNR-MICCAI-BraTS2023-GLI-Challenge-TrainingData/BraTS-GLI-00243-000/BraTS-GLI-00243-000-t2f.nii.gz,../../DataSet/ASNR-MICCAI-BraTS2023-GLI-Challenge-TrainingData/BraTS-GLI-00243-000/BraTS-GLI-00243-000-t1n.nii.gz,../../DataSet/ASNR-MICCAI-BraTS2023-GLI-Challenge-TrainingData/BraTS-GLI-00243-000/BraTS-GLI-00243-000-seg.nii.gz,103,151,31,67,135,112,184,7,61,68,72,54
00622-000,../../DataSet/ASNR-MICCAI-BraTS2023-GLI-Challenge-TrainingData/BraTS-GLI-00622-000/BraTS-GLI-00622-000-t1c.nii.gz,../../DataSet/ASNR-MICCAI-BraTS2023-GLI-Challenge-TrainingData/BraTS-GLI-00622-000/BraTS-GLI-00622-000-t2w.nii.gz,../../DataSet/ASNR-MICCAI-BraTS2023-GLI-Challenge-TrainingData/BraTS-GLI-00622-000/BraTS-GLI-00622-000-t2f.nii.gz,../../DataSet/ASNR-MICCAI-BraTS2023-GLI-Challenge-TrainingData/BraTS-GLI-00622-000/BraTS-GLI-00622-000-t1n.nii.gz,../../DataSet/ASNR-MICCAI-BraTS2023-GLI-Challenge-TrainingData/BraTS-GLI-00622-000/BraTS-GLI-00622-000-seg.nii.gz,163,150,67,144,184,123,180,48,90,40,57,42
01062-000,../../DataSet/ASNR-MICCAI-BraTS2023-GLI-Challenge-TrainingData/BraTS-GLI-01062-000/BraTS-GLI-01062-000-t1c.nii.gz,../../DataSet/ASNR-MICCAI-BraTS2023-GLI-Challenge-TrainingData/BraTS-GLI-01062-000/BraTS-GLI-01062-000-t2w.nii.gz,../../DataSet/ASNR-MICCAI-BraTS2023-GLI-Challenge-TrainingData/BraTS-GLI-01062-000/BraTS-GLI-01062-000-t2f.nii.gz,../../DataSet/ASNR-MICCAI-BraTS2023-GLI-Challenge-TrainingData/BraTS-GLI-01062-000/BraTS-GLI-01062-000-t1n.nii.gz,../../DataSet/ASNR-MICCAI-BraTS2023-GLI-Challenge-TrainingData/BraTS-GLI-01062-000/BraTS-GLI-01062-000-seg.nii.gz,99,102,98,63,138,60,145,65,131,75,85,66
00818-000,../../DataSet/ASNR-MICCAI-BraTS2023-GLI-Challenge-TrainingData/BraTS-GLI-00818-000/BraTS-GLI-00818-000-t1c.nii.gz,../../DataSet/ASNR-MICCAI-BraTS2023-GLI-Challenge-TrainingData/BraTS-GLI-00818-000/BraTS-GLI-00818-000-t2w.nii.gz,../../DataSet/ASNR-MICCAI-BraTS2023-GLI-Challenge-TrainingData/BraTS-GLI-00818-000/BraTS-GLI-00818-000-t2f.nii.gz,../../DataSet/ASNR-MICCAI-BraTS2023-GLI-Challenge-TrainingData/BraTS-GLI-00818-000/BraTS-GLI-00818-000-t1n.nii.gz,../../DataSet/ASNR-MICCAI-BraTS2023-GLI-Challenge-TrainingData/BraTS-GLI-00818-000/BraTS-GLI-00818-000-seg.nii.gz,89,160,96,54,118,124,200,57,131,64,76,74
01372-000,../../DataSet/ASNR-MICCAI-BraTS2023-GLI-Challenge-TrainingData/BraTS-GLI-01372-000/BraTS-GLI-01372-000-t1c.nii.gz,../../DataSet/ASNR-MICCAI-BraTS2023-GLI-Challenge-TrainingData/BraTS-GLI-01372-000/BraTS-GLI-01372-000-t2w.nii.gz,../../DataSet/ASNR-MICCAI-BraTS2023-GLI-Challenge-TrainingData/BraTS-GLI-01372-000/BraTS-GLI-01372-000-t2f.nii.gz,../../DataSet/ASNR-MICCAI-BraTS2023-GLI-Challenge-TrainingData/BraTS-GLI-01372-000/BraTS-GLI-01372-000-t1n.nii.gz,../../DataSet/ASNR-MICCAI-BraTS2023-GLI-Challenge-TrainingData/BraTS-GLI-01372-000/BraTS-GLI-01372-000-seg.nii.gz,105,160,98,87,122,126,189,64,126,35,63,62
00532-000,../../DataSet/ASNR-MICCAI-BraTS2023-GLI-Challenge-TrainingData/BraTS-GLI-00532-000/BraTS-GLI-00532-000-t1c.nii.gz,../../DataSet/ASNR-MICCAI-BraTS2023-GLI-Challenge-TrainingData/BraTS-GLI-00532-000/BraTS-GLI-00532-000-t2w.nii.gz,../../DataSet/ASNR-MICCAI-BraTS2023-GLI-Challenge-TrainingData/BraTS-GLI-00532-000/BraTS-GLI-00532-000-t2f.nii.gz,../../DataSet/ASNR-MICCAI-BraTS2023-GLI-Challenge-TrainingData/BraTS-GLI-00532-000/BraTS-GLI-00532-000-t1n.nii.gz,../../DataSet/ASNR-MICCAI-BraTS2023-GLI-Challenge-TrainingData/BraTS-GLI-00532-000/BraTS-GLI-00532-000-seg.nii.gz,102,89,101,69,143,43,137,73,136,74,94,63
01404-000,../../DataSet/ASNR-MICCAI-BraTS2023-GLI-Challenge-TrainingData/BraTS-GLI-01404-000/BraTS-GLI-01404-000-t1c.nii.gz,../../DataSet/ASNR-MICCAI-BraTS2023-GLI-Challenge-TrainingData/BraTS-GLI-01404-000/BraTS-GLI-01404-000-t2w.nii.gz,../../DataSet/ASNR-MICCAI-BraTS2023-GLI-Challenge-TrainingData/BraTS-GLI-01404-000/BraTS-GLI-01404-000-t2f.nii.gz,../../DataSet/ASNR-MICCAI-BraTS2023-GLI-Challenge-TrainingData/BraTS-GLI-01404-000/BraTS-GLI-01404-000-t1n.nii.gz,../../DataSet/ASNR-MICCAI-BraTS2023-GLI-Challenge-TrainingData/BraTS-GLI-01404-000/BraTS-GLI-01404-000-seg.nii.gz,118,119,58,88,138,92,174,44,93,50,82,49
01065-000,../../DataSet/ASNR-MICCAI-BraTS2023-GLI-Challenge-TrainingData/BraTS-GLI-01065-000/BraTS-GLI-01065-000-t1c.nii.gz,../../DataSet/ASNR-MICCAI-BraTS2023-GLI-Challenge-TrainingData/BraTS-GLI-01065-000/BraTS-GLI-01065-000-t2w.nii.gz,../../DataSet/ASNR-MICCAI-BraTS2023-GLI-Challenge-TrainingData/BraTS-GLI-01065-000/BraTS-GLI-01065-000-t2f.nii.gz,../../DataSet/ASNR-MICCAI-BraTS2023-GLI-Challenge-TrainingData/BraTS-GLI-01065-000/BraTS-GLI-01065-000-t1n.nii.gz,../../DataSet/ASNR-MICCAI-BraTS2023-GLI-Challenge-TrainingData/BraTS-GLI-01065-000/BraTS-GLI-01065-000-seg.nii.gz,84,138,79,49,122,92,184,46,116,73,92,70
00625-000,../../DataSet/ASNR-MICCAI-BraTS2023-GLI-Challenge-TrainingData/BraTS-GLI-00625-000/BraTS-GLI-00625-000-t1c.nii.gz,../../DataSet/ASNR-MICCAI-BraTS2023-GLI-Challenge-TrainingData/BraTS-GLI-00625-000/BraTS-GLI-00625-000-t2w.nii.gz,../../DataSet/ASNR-MICCAI-BraTS2023-GLI-Challenge-TrainingData/BraTS-GLI-00625-000/BraTS-GLI-00625-000-t2f.nii.gz,../../DataSet/ASNR-MICCAI-BraTS2023-GLI-Challenge-TrainingData/BraTS-GLI-00625-000/BraTS-GLI-00625-000-t1n.nii.gz,../../DataSet/ASNR-MICCAI-BraTS2023-GLI-Challenge-TrainingData/BraTS-GLI-00625-000/BraTS-GLI-00625-000-seg.nii.gz,148,159,100,124,186,120,206,61,145,62,86,84
00545-001,../../DataSet/ASNR-MICCAI-BraTS2023-GLI-Challenge-TrainingData/BraTS-GLI-00545-001/BraTS-GLI-00545-001-t1c.nii.gz,../../DataSet/ASNR-MICCAI-BraTS2023-GLI-Challenge-TrainingData/BraTS-GLI-00545-001/BraTS-GLI-00545-001-t2w.nii.gz,../../DataSet/ASNR-MICCAI-BraTS2023-GLI-Challenge-TrainingData/BraTS-GLI-00545-001/BraTS-GLI-00545-001-t2f.nii.gz,../../DataSet/ASNR-MICCAI-BraTS2023-GLI-Challenge-TrainingData/BraTS-GLI-00545-001/BraTS-GLI-00545-001-t1n.nii.gz,../../DataSet/ASNR-MICCAI-BraTS2023-GLI-Challenge-TrainingData/BraTS-GLI-00545-001/BraTS-GLI-00545-001-seg.nii.gz,161,133,63,134,186,99,169,36,89,52,70,53
00360-000,../../DataSet/ASNR-MICCAI-BraTS2023-GLI-Challenge-TrainingData/BraTS-GLI-00360-000/BraTS-GLI-00360-000-t1c.nii.gz,../../DataSet/ASNR-MICCAI-BraTS2023-GLI-Challenge-TrainingData/BraTS-GLI-00360-000/BraTS-GLI-00360-000-t2w.nii.gz,../../DataSet/ASNR-MICCAI-BraTS2023-GLI-Challenge-TrainingData/BraTS-GLI-00360-000/BraTS-GLI-00360-000-t2f.nii.gz,../../DataSet/ASNR-MICCAI-BraTS2023-GLI-Challenge-TrainingData/BraTS-GLI-00360-000/BraTS-GLI-00360-000-t1n.nii.gz,../../DataSet/ASNR-MICCAI-BraTS2023-GLI-Challenge-TrainingData/BraTS-GLI-00360-000/BraTS-GLI-00360-000-seg.nii.gz,137,162,87,110,173,126,201,48,125,63,75,77
01520-000,../../DataSet/ASNR-MICCAI-BraTS2023-GLI-Challenge-TrainingData/BraTS-GLI-01520-000/BraTS-GLI-01520-000-t1c.nii.gz,../../DataSet/ASNR-MICCAI-BraTS2023-GLI-Challenge-TrainingData/BraTS-GLI-01520-000/BraTS-GLI-01520-000-t2w.nii.gz,../../DataSet/ASNR-MICCAI-BraTS2023-GLI-Challenge-TrainingData/BraTS-GLI-01520-000/BraTS-GLI-01520-000-t2f.nii.gz,../../DataSet/ASNR-MICCAI-BraTS2023-GLI-Challenge-TrainingData/BraTS-GLI-01520-000/BraTS-GLI-01520-000-t1n.nii.gz,../../DataSet/ASNR-MICCAI-BraTS2023-GLI-Challenge-TrainingData/BraTS-GLI-01520-000/BraTS-GLI-01520-000-seg.nii.gz,155,130,106,137,175,109,152,86,129,38,43,43
01141-000,../../DataSet/ASNR-MICCAI-BraTS2023-GLI-Challenge-TrainingData/BraTS-GLI-01141-000/BraTS-GLI-01141-000-t1c.nii.gz,../../DataSet/ASNR-MICCAI-BraTS2023-GLI-Challenge-TrainingData/BraTS-GLI-01141-000/BraTS-GLI-01141-000-t2w.nii.gz,../../DataSet/ASNR-MICCAI-BraTS2023-GLI-Challenge-TrainingData/BraTS-GLI-01141-000/BraTS-GLI-01141-000-t2f.nii.gz,../../DataSet/ASNR-MICCAI-BraTS2023-GLI-Challenge-TrainingData/BraTS-GLI-01141-000/BraTS-GLI-01141-000-t1n.nii.gz,../../DataSet/ASNR-MICCAI-BraTS2023-GLI-Challenge-TrainingData/BraTS-GLI-01141-000/BraTS-GLI-01141-000-seg.nii.gz,142,151,91,118,178,108,200,54,131,60,92,77
01256-000,../../DataSet/ASNR-MICCAI-BraTS2023-GLI-Challenge-TrainingData/BraTS-GLI-01256-000/BraTS-GLI-01256-000-t1c.nii.gz,../../DataSet/ASNR-MICCAI-BraTS2023-GLI-Challenge-TrainingData/BraTS-GLI-01256-000/BraTS-GLI-01256-000-t2w.nii.gz,../../DataSet/ASNR-MICCAI-BraTS2023-GLI-Challenge-TrainingData/BraTS-GLI-01256-000/BraTS-GLI-01256-000-t2f.nii.gz,../../DataSet/ASNR-MICCAI-BraTS2023-GLI-Challenge-TrainingData/BraTS-GLI-01256-000/BraTS-GLI-01256-000-t1n.nii.gz,../../DataSet/ASNR-MICCAI-BraTS2023-GLI-Challenge-TrainingData/BraTS-GLI-01256-000/BraTS-GLI-01256-000-seg.nii.gz,80,140,74,50,116,92,186,43,111,66,94,68
00688-000,../../DataSet/ASNR-MICCAI-BraTS2023-GLI-Challenge-TrainingData/BraTS-GLI-00688-000/BraTS-GLI-00688-000-t1c.nii.gz,../../DataSet/ASNR-MICCAI-BraTS2023-GLI-Challenge-TrainingData/BraTS-GLI-00688-000/BraTS-GLI-00688-000-t2w.nii.gz,../../DataSet/ASNR-MICCAI-BraTS2023-GLI-Challenge-TrainingData/BraTS-GLI-00688-000/BraTS-GLI-00688-000-t2f.nii.gz,../../DataSet/ASNR-MICCAI-BraTS2023-GLI-Challenge-TrainingData/BraTS-GLI-00688-000/BraTS-GLI-00688-000-t1n.nii.gz,../../DataSet/ASNR-MICCAI-BraTS2023-GLI-Challenge-TrainingData/BraTS-GLI-00688-000/BraTS-GLI-00688-000-seg.nii.gz,149,121,44,132,169,96,148,25,65,37,52,40
00238-000,../../DataSet/ASNR-MICCAI-BraTS2023-GLI-Challenge-TrainingData/BraTS-GLI-00238-000/BraTS-GLI-00238-000-t1c.nii.gz,../../DataSet/ASNR-MICCAI-BraTS2023-GLI-Challenge-TrainingData/BraTS-GLI-00238-000/BraTS-GLI-00238-000-t2w.nii.gz,../../DataSet/ASNR-MICCAI-BraTS2023-GLI-Challenge-TrainingData/BraTS-GLI-00238-000/BraTS-GLI-00238-000-t2f.nii.gz,../../DataSet/ASNR-MICCAI-BraTS2023-GLI-Challenge-TrainingData/BraTS-GLI-00238-000/BraTS-GLI-00238-000-t1n.nii.gz,../../DataSet/ASNR-MICCAI-BraTS2023-GLI-Challenge-TrainingData/BraTS-GLI-00238-000/BraTS-GLI-00238-000-seg.nii.gz,119,133,98,88,147,107,163,68,133,59,56,65
01019-000,../../DataSet/ASNR-MICCAI-BraTS2023-GLI-Challenge-TrainingData/BraTS-GLI-01019-000/BraTS-GLI-01019-000-t1c.nii.gz,../../DataSet/ASNR-MICCAI-BraTS2023-GLI-Challenge-TrainingData/BraTS-GLI-01019-000/BraTS-GLI-01019-000-t2w.nii.gz,../../DataSet/ASNR-MICCAI-BraTS2023-GLI-Challenge-TrainingData/BraTS-GLI-01019-000/BraTS-GLI-01019-000-t2f.nii.gz,../../DataSet/ASNR-MICCAI-BraTS2023-GLI-Challenge-TrainingData/BraTS-GLI-01019-000/BraTS-GLI-01019-000-t1n.nii.gz,../../DataSet/ASNR-MICCAI-BraTS2023-GLI-Challenge-TrainingData/BraTS-GLI-01019-000/BraTS-GLI-01019-000-seg.nii.gz,141,161,87,103,175,118,203,52,136,72,85,84
00659-000,../../DataSet/ASNR-MICCAI-BraTS2023-GLI-Challenge-TrainingData/BraTS-GLI-00659-000/BraTS-GLI-00659-000-t1c.nii.gz,../../DataSet/ASNR-MICCAI-BraTS2023-GLI-Challenge-TrainingData/BraTS-GLI-00659-000/BraTS-GLI-00659-000-t2w.nii.gz,../../DataSet/ASNR-MICCAI-BraTS2023-GLI-Challenge-TrainingData/BraTS-GLI-00659-000/BraTS-GLI-00659-000-t2f.nii.gz,../../DataSet/ASNR-MICCAI-BraTS2023-GLI-Challenge-TrainingData/BraTS-GLI-00659-000/BraTS-GLI-00659-000-t1n.nii.gz,../../DataSet/ASNR-MICCAI-BraTS2023-GLI-Challenge-TrainingData/BraTS-GLI-00659-000/BraTS-GLI-00659-000-seg.nii.gz,149,159,103,129,175,137,182,62,125,46,45,63
01415-000,../../DataSet/ASNR-MICCAI-BraTS2023-GLI-Challenge-TrainingData/BraTS-GLI-01415-000/BraTS-GLI-01415-000-t1c.nii.gz,../../DataSet/ASNR-MICCAI-BraTS2023-GLI-Challenge-TrainingData/BraTS-GLI-01415-000/BraTS-GLI-01415-000-t2w.nii.gz,../../DataSet/ASNR-MICCAI-BraTS2023-GLI-Challenge-TrainingData/BraTS-GLI-01415-000/BraTS-GLI-01415-000-t2f.nii.gz,../../DataSet/ASNR-MICCAI-BraTS2023-GLI-Challenge-TrainingData/BraTS-GLI-01415-000/BraTS-GLI-01415-000-t1n.nii.gz,../../DataSet/ASNR-MICCAI-BraTS2023-GLI-Challenge-TrainingData/BraTS-GLI-01415-000/BraTS-GLI-01415-000-seg.nii.gz,85,168,93,54,114,123,209,60,135,60,86,75
01074-000,../../DataSet/ASNR-MICCAI-BraTS2023-GLI-Challenge-TrainingData/BraTS-GLI-01074-000/BraTS-GLI-01074-000-t1c.nii.gz,../../DataSet/ASNR-MICCAI-BraTS2023-GLI-Challenge-TrainingData/BraTS-GLI-01074-000/BraTS-GLI-01074-000-t2w.nii.gz,../../DataSet/ASNR-MICCAI-BraTS2023-GLI-Challenge-TrainingData/BraTS-GLI-01074-000/BraTS-GLI-01074-000-t2f.nii.gz,../../DataSet/ASNR-MICCAI-BraTS2023-GLI-Challenge-TrainingData/BraTS-GLI-01074-000/BraTS-GLI-01074-000-t1n.nii.gz,../../DataSet/ASNR-MICCAI-BraTS2023-GLI-Challenge-TrainingData/BraTS-GLI-01074-000/BraTS-GLI-01074-000-seg.nii.gz,144,102,101,114,176,65,139,73,135,62,74,62
00193-000,../../DataSet/ASNR-MICCAI-BraTS2023-GLI-Challenge-TrainingData/BraTS-GLI-00193-000/BraTS-GLI-00193-000-t1c.nii.gz,../../DataSet/ASNR-MICCAI-BraTS2023-GLI-Challenge-TrainingData/BraTS-GLI-00193-000/BraTS-GLI-00193-000-t2w.nii.gz,../../DataSet/ASNR-MICCAI-BraTS2023-GLI-Challenge-TrainingData/BraTS-GLI-00193-000/BraTS-GLI-00193-000-t2f.nii.gz,../../DataSet/ASNR-MICCAI-BraTS2023-GLI-Challenge-TrainingData/BraTS-GLI-00193-000/BraTS-GLI-00193-000-t1n.nii.gz,../../DataSet/ASNR-MICCAI-BraTS2023-GLI-Challenge-TrainingData/BraTS-GLI-00193-000/BraTS-GLI-00193-000-seg.nii.gz,118,145,38,97,139,111,181,1,74,42,70,73
00767-001,../../DataSet/ASNR-MICCAI-BraTS2023-GLI-Challenge-TrainingData/BraTS-GLI-00767-001/BraTS-GLI-00767-001-t1c.nii.gz,../../DataSet/ASNR-MICCAI-BraTS2023-GLI-Challenge-TrainingData/BraTS-GLI-00767-001/BraTS-GLI-00767-001-t2w.nii.gz,../../DataSet/ASNR-MICCAI-BraTS2023-GLI-Challenge-TrainingData/BraTS-GLI-00767-001/BraTS-GLI-00767-001-t2f.nii.gz,../../DataSet/ASNR-MICCAI-BraTS2023-GLI-Challenge-TrainingData/BraTS-GLI-00767-001/BraTS-GLI-00767-001-t1n.nii.gz,../../DataSet/ASNR-MICCAI-BraTS2023-GLI-Challenge-TrainingData/BraTS-GLI-00767-001/BraTS-GLI-00767-001-seg.nii.gz,145,155,104,122,176,127,190,70,135,54,63,65
01363-000,../../DataSet/ASNR-MICCAI-BraTS2023-GLI-Challenge-TrainingData/BraTS-GLI-01363-000/BraTS-GLI-01363-000-t1c.nii.gz,../../DataSet/ASNR-MICCAI-BraTS2023-GLI-Challenge-TrainingData/BraTS-GLI-01363-000/BraTS-GLI-01363-000-t2w.nii.gz,../../DataSet/ASNR-MICCAI-BraTS2023-GLI-Challenge-TrainingData/BraTS-GLI-01363-000/BraTS-GLI-01363-000-t2f.nii.gz,../../DataSet/ASNR-MICCAI-BraTS2023-GLI-Challenge-TrainingData/BraTS-GLI-01363-000/BraTS-GLI-01363-000-t1n.nii.gz,../../DataSet/ASNR-MICCAI-BraTS2023-GLI-Challenge-TrainingData/BraTS-GLI-01363-000/BraTS-GLI-01363-000-seg.nii.gz,113,141,116,105,121,128,157,104,129,16,29,25
00523-000,../../DataSet/ASNR-MICCAI-BraTS2023-GLI-Challenge-TrainingData/BraTS-GLI-00523-000/BraTS-GLI-00523-000-t1c.nii.gz,../../DataSet/ASNR-MICCAI-BraTS2023-GLI-Challenge-TrainingData/BraTS-GLI-00523-000/BraTS-GLI-00523-000-t2w.nii.gz,../../DataSet/ASNR-MICCAI-BraTS2023-GLI-Challenge-TrainingData/BraTS-GLI-00523-000/BraTS-GLI-00523-000-t2f.nii.gz,../../DataSet/ASNR-MICCAI-BraTS2023-GLI-Challenge-TrainingData/BraTS-GLI-00523-000/BraTS-GLI-00523-000-t1n.nii.gz,../../DataSet/ASNR-MICCAI-BraTS2023-GLI-Challenge-TrainingData/BraTS-GLI-00523-000/BraTS-GLI-00523-000-seg.nii.gz,97,125,55,75,122,91,158,26,86,47,67,60
00284-000,../../DataSet/ASNR-MICCAI-BraTS2023-GLI-Challenge-TrainingData/BraTS-GLI-00284-000/BraTS-GLI-00284-000-t1c.nii.gz,../../DataSet/ASNR-MICCAI-BraTS2023-GLI-Challenge-TrainingData/BraTS-GLI-00284-000/BraTS-GLI-00284-000-t2w.nii.gz,../../DataSet/ASNR-MICCAI-BraTS2023-GLI-Challenge-TrainingData/BraTS-GLI-00284-000/BraTS-GLI-00284-000-t2f.nii.gz,../../DataSet/ASNR-MICCAI-BraTS2023-GLI-Challenge-TrainingData/BraTS-GLI-00284-000/BraTS-GLI-00284-000-t1n.nii.gz,../../DataSet/ASNR-MICCAI-BraTS2023-GLI-Challenge-TrainingData/BraTS-GLI-00284-000/BraTS-GLI-00284-000-seg.nii.gz,111,109,99,84,138,83,143,71,135,54,60,64
00809-000,../../DataSet/ASNR-MICCAI-BraTS2023-GLI-Challenge-TrainingData/BraTS-GLI-00809-000/BraTS-GLI-00809-000-t1c.nii.gz,../../DataSet/ASNR-MICCAI-BraTS2023-GLI-Challenge-TrainingData/BraTS-GLI-00809-000/BraTS-GLI-00809-000-t2w.nii.gz,../../DataSet/ASNR-MICCAI-BraTS2023-GLI-Challenge-TrainingData/BraTS-GLI-00809-000/BraTS-GLI-00809-000-t2f.nii.gz,../../DataSet/ASNR-MICCAI-BraTS2023-GLI-Challenge-TrainingData/BraTS-GLI-00809-000/BraTS-GLI-00809-000-t1n.nii.gz,../../DataSet/ASNR-MICCAI-BraTS2023-GLI-Challenge-TrainingData/BraTS-GLI-00809-000/BraTS-GLI-00809-000-seg.nii.gz,160,133,62,120,189,85,180,23,99,69,95,76
01008-000,../../DataSet/ASNR-MICCAI-BraTS2023-GLI-Challenge-TrainingData/BraTS-GLI-01008-000/BraTS-GLI-01008-000-t1c.nii.gz,../../DataSet/ASNR-MICCAI-BraTS2023-GLI-Challenge-TrainingData/BraTS-GLI-01008-000/BraTS-GLI-01008-000-t2w.nii.gz,../../DataSet/ASNR-MICCAI-BraTS2023-GLI-Challenge-TrainingData/BraTS-GLI-01008-000/BraTS-GLI-01008-000-t2f.nii.gz,../../DataSet/ASNR-MICCAI-BraTS2023-GLI-Challenge-TrainingData/BraTS-GLI-01008-000/BraTS-GLI-01008-000-t1n.nii.gz,../../DataSet/ASNR-MICCAI-BraTS2023-GLI-Challenge-TrainingData/BraTS-GLI-01008-000/BraTS-GLI-01008-000-seg.nii.gz,93,112,87,74,129,74,143,63,113,55,69,50
00066-000,../../DataSet/ASNR-MICCAI-BraTS2023-GLI-Challenge-TrainingData/BraTS-GLI-00066-000/BraTS-GLI-00066-000-t1c.nii.gz,../../DataSet/ASNR-MICCAI-BraTS2023-GLI-Challenge-TrainingData/BraTS-GLI-00066-000/BraTS-GLI-00066-000-t2w.nii.gz,../../DataSet/ASNR-MICCAI-BraTS2023-GLI-Challenge-TrainingData/BraTS-GLI-00066-000/BraTS-GLI-00066-000-t2f.nii.gz,../../DataSet/ASNR-MICCAI-BraTS2023-GLI-Challenge-TrainingData/BraTS-GLI-00066-000/BraTS-GLI-00066-000-t1n.nii.gz,../../DataSet/ASNR-MICCAI-BraTS2023-GLI-Challenge-TrainingData/BraTS-GLI-00066-000/BraTS-GLI-00066-000-seg.nii.gz,83,104,91,63,109,81,129,66,124,46,48,58
01181-000,../../DataSet/ASNR-MICCAI-BraTS2023-GLI-Challenge-TrainingData/BraTS-GLI-01181-000/BraTS-GLI-01181-000-t1c.nii.gz,../../DataSet/ASNR-MICCAI-BraTS2023-GLI-Challenge-TrainingData/BraTS-GLI-01181-000/BraTS-GLI-01181-000-t2w.nii.gz,../../DataSet/ASNR-MICCAI-BraTS2023-GLI-Challenge-TrainingData/BraTS-GLI-01181-000/BraTS-GLI-01181-000-t2f.nii.gz,../../DataSet/ASNR-MICCAI-BraTS2023-GLI-Challenge-TrainingData/BraTS-GLI-01181-000/BraTS-GLI-01181-000-t1n.nii.gz,../../DataSet/ASNR-MICCAI-BraTS2023-GLI-Challenge-TrainingData/BraTS-GLI-01181-000/BraTS-GLI-01181-000-seg.nii.gz,158,132,76,140,174,97,158,51,99,34,61,48
01247-000,../../DataSet/ASNR-MICCAI-BraTS2023-GLI-Challenge-TrainingData/BraTS-GLI-01247-000/BraTS-GLI-01247-000-t1c.nii.gz,../../DataSet/ASNR-MICCAI-BraTS2023-GLI-Challenge-TrainingData/BraTS-GLI-01247-000/BraTS-GLI-01247-000-t2w.nii.gz,../../DataSet/ASNR-MICCAI-BraTS2023-GLI-Challenge-TrainingData/BraTS-GLI-01247-000/BraTS-GLI-01247-000-t2f.nii.gz,../../DataSet/ASNR-MICCAI-BraTS2023-GLI-Challenge-TrainingData/BraTS-GLI-01247-000/BraTS-GLI-01247-000-t1n.nii.gz,../../DataSet/ASNR-MICCAI-BraTS2023-GLI-Challenge-TrainingData/BraTS-GLI-01247-000/BraTS-GLI-01247-000-seg.nii.gz,147,111,59,121,173,85,148,34,87,52,63,53
00407-000,../../DataSet/ASNR-MICCAI-BraTS2023-GLI-Challenge-TrainingData/BraTS-GLI-00407-000/BraTS-GLI-00407-000-t1c.nii.gz,../../DataSet/ASNR-MICCAI-BraTS2023-GLI-Challenge-TrainingData/BraTS-GLI-00407-000/BraTS-GLI-00407-000-t2w.nii.gz,../../DataSet/ASNR-MICCAI-BraTS2023-GLI-Challenge-TrainingData/BraTS-GLI-00407-000/BraTS-GLI-00407-000-t2f.nii.gz,../../DataSet/ASNR-MICCAI-BraTS2023-GLI-Challenge-TrainingData/BraTS-GLI-00407-000/BraTS-GLI-00407-000-t1n.nii.gz,../../DataSet/ASNR-MICCAI-BraTS2023-GLI-Challenge-TrainingData/BraTS-GLI-00407-000/BraTS-GLI-00407-000-seg.nii.gz,87,136,98,57,117,89,179,54,139,60,90,85
00371-000,../../DataSet/ASNR-MICCAI-BraTS2023-GLI-Challenge-TrainingData/BraTS-GLI-00371-000/BraTS-GLI-00371-000-t1c.nii.gz,../../DataSet/ASNR-MICCAI-BraTS2023-GLI-Challenge-TrainingData/BraTS-GLI-00371-000/BraTS-GLI-00371-000-t2w.nii.gz,../../DataSet/ASNR-MICCAI-BraTS2023-GLI-Challenge-TrainingData/BraTS-GLI-00371-000/BraTS-GLI-00371-000-t2f.nii.gz,../../DataSet/ASNR-MICCAI-BraTS2023-GLI-Challenge-TrainingData/BraTS-GLI-00371-000/BraTS-GLI-00371-000-t1n.nii.gz,../../DataSet/ASNR-MICCAI-BraTS2023-GLI-Challenge-TrainingData/BraTS-GLI-00371-000/BraTS-GLI-00371-000-seg.nii.gz,93,167,94,66,117,138,203,53,134,51,65,81
01531-000,../../DataSet/ASNR-MICCAI-BraTS2023-GLI-Challenge-TrainingData/BraTS-GLI-01531-000/BraTS-GLI-01531-000-t1c.nii.gz,../../DataSet/ASNR-MICCAI-BraTS2023-GLI-Challenge-TrainingData/BraTS-GLI-01531-000/BraTS-GLI-01531-000-t2w.nii.gz,../../DataSet/ASNR-MICCAI-BraTS2023-GLI-Challenge-TrainingData/BraTS-GLI-01531-000/BraTS-GLI-01531-000-t2f.nii.gz,../../DataSet/ASNR-MICCAI-BraTS2023-GLI-Challenge-TrainingData/BraTS-GLI-01531-000/BraTS-GLI-01531-000-t1n.nii.gz,../../DataSet/ASNR-MICCAI-BraTS2023-GLI-Challenge-TrainingData/BraTS-GLI-01531-000/BraTS-GLI-01531-000-seg.nii.gz,137,164,91,112,169,122,205,50,127,57,83,77
01296-000,../../DataSet/ASNR-MICCAI-BraTS2023-GLI-Challenge-TrainingData/BraTS-GLI-01296-000/BraTS-GLI-01296-000-t1c.nii.gz,../../DataSet/ASNR-MICCAI-BraTS2023-GLI-Challenge-TrainingData/BraTS-GLI-01296-000/BraTS-GLI-01296-000-t2w.nii.gz,../../DataSet/ASNR-MICCAI-BraTS2023-GLI-Challenge-TrainingData/BraTS-GLI-01296-000/BraTS-GLI-01296-000-t2f.nii.gz,../../DataSet/ASNR-MICCAI-BraTS2023-GLI-Challenge-TrainingData/BraTS-GLI-01296-000/BraTS-GLI-01296-000-t1n.nii.gz,../../DataSet/ASNR-MICCAI-BraTS2023-GLI-Challenge-TrainingData/BraTS-GLI-01296-000/BraTS-GLI-01296-000-seg.nii.gz,84,126,70,54,123,84,180,29,106,69,96,77
00692-001,../../DataSet/ASNR-MICCAI-BraTS2023-GLI-Challenge-TrainingData/BraTS-GLI-00692-001/BraTS-GLI-00692-001-t1c.nii.gz,../../DataSet/ASNR-MICCAI-BraTS2023-GLI-Challenge-TrainingData/BraTS-GLI-00692-001/BraTS-GLI-00692-001-t2w.nii.gz,../../DataSet/ASNR-MICCAI-BraTS2023-GLI-Challenge-TrainingData/BraTS-GLI-00692-001/BraTS-GLI-00692-001-t2f.nii.gz,../../DataSet/ASNR-MICCAI-BraTS2023-GLI-Challenge-TrainingData/BraTS-GLI-00692-001/BraTS-GLI-00692-001-t1n.nii.gz,../../DataSet/ASNR-MICCAI-BraTS2023-GLI-Challenge-TrainingData/BraTS-GLI-00692-001/BraTS-GLI-00692-001-seg.nii.gz,97,138,112,71,128,109,175,84,144,57,66,60
00589-000,../../DataSet/ASNR-MICCAI-BraTS2023-GLI-Challenge-TrainingData/BraTS-GLI-00589-000/BraTS-GLI-00589-000-t1c.nii.gz,../../DataSet/ASNR-MICCAI-BraTS2023-GLI-Challenge-TrainingData/BraTS-GLI-00589-000/BraTS-GLI-00589-000-t2w.nii.gz,../../DataSet/ASNR-MICCAI-BraTS2023-GLI-Challenge-TrainingData/BraTS-GLI-00589-000/BraTS-GLI-00589-000-t2f.nii.gz,../../DataSet/ASNR-MICCAI-BraTS2023-GLI-Challenge-TrainingData/BraTS-GLI-00589-000/BraTS-GLI-00589-000-t1n.nii.gz,../../DataSet/ASNR-MICCAI-BraTS2023-GLI-Challenge-TrainingData/BraTS-GLI-00589-000/BraTS-GLI-00589-000-seg.nii.gz,93,105,106,62,124,62,145,83,133,62,83,50
00139-000,../../DataSet/ASNR-MICCAI-BraTS2023-GLI-Challenge-TrainingData/BraTS-GLI-00139-000/BraTS-GLI-00139-000-t1c.nii.gz,../../DataSet/ASNR-MICCAI-BraTS2023-GLI-Challenge-TrainingData/BraTS-GLI-00139-000/BraTS-GLI-00139-000-t2w.nii.gz,../../DataSet/ASNR-MICCAI-BraTS2023-GLI-Challenge-TrainingData/BraTS-GLI-00139-000/BraTS-GLI-00139-000-t2f.nii.gz,../../DataSet/ASNR-MICCAI-BraTS2023-GLI-Challenge-TrainingData/BraTS-GLI-00139-000/BraTS-GLI-00139-000-t1n.nii.gz,../../DataSet/ASNR-MICCAI-BraTS2023-GLI-Challenge-TrainingData/BraTS-GLI-00139-000/BraTS-GLI-00139-000-seg.nii.gz,145,122,64,109,174,88,166,36,95,65,78,59
00558-000,../../DataSet/ASNR-MICCAI-BraTS2023-GLI-Challenge-TrainingData/BraTS-GLI-00558-000/BraTS-GLI-00558-000-t1c.nii.gz,../../DataSet/ASNR-MICCAI-BraTS2023-GLI-Challenge-TrainingData/BraTS-GLI-00558-000/BraTS-GLI-00558-000-t2w.nii.gz,../../DataSet/ASNR-MICCAI-BraTS2023-GLI-Challenge-TrainingData/BraTS-GLI-00558-000/BraTS-GLI-00558-000-t2f.nii.gz,../../DataSet/ASNR-MICCAI-BraTS2023-GLI-Challenge-TrainingData/BraTS-GLI-00558-000/BraTS-GLI-00558-000-t1n.nii.gz,../../DataSet/ASNR-MICCAI-BraTS2023-GLI-Challenge-TrainingData/BraTS-GLI-00558-000/BraTS-GLI-00558-000-seg.nii.gz,103,84,95,63,140,35,130,59,136,77,95,77
01318-000,../../DataSet/ASNR-MICCAI-BraTS2023-GLI-Challenge-TrainingData/BraTS-GLI-01318-000/BraTS-GLI-01318-000-t1c.nii.gz,../../DataSet/ASNR-MICCAI-BraTS2023-GLI-Challenge-TrainingData/BraTS-GLI-01318-000/BraTS-GLI-01318-000-t2w.nii.gz,../../DataSet/ASNR-MICCAI-BraTS2023-GLI-Challenge-TrainingData/BraTS-GLI-01318-000/BraTS-GLI-01318-000-t2f.nii.gz,../../DataSet/ASNR-MICCAI-BraTS2023-GLI-Challenge-TrainingData/BraTS-GLI-01318-000/BraTS-GLI-01318-000-t1n.nii.gz,../../DataSet/ASNR-MICCAI-BraTS2023-GLI-Challenge-TrainingData/BraTS-GLI-01318-000/BraTS-GLI-01318-000-seg.nii.gz,157,164,61,137,184,135,187,44,83,47,52,39
01186-000,../../DataSet/ASNR-MICCAI-BraTS2023-GLI-Challenge-TrainingData/BraTS-GLI-01186-000/BraTS-GLI-01186-000-t1c.nii.gz,../../DataSet/ASNR-MICCAI-BraTS2023-GLI-Challenge-TrainingData/BraTS-GLI-01186-000/BraTS-GLI-01186-000-t2w.nii.gz,../../DataSet/ASNR-MICCAI-BraTS2023-GLI-Challenge-TrainingData/BraTS-GLI-01186-000/BraTS-GLI-01186-000-t2f.nii.gz,../../DataSet/ASNR-MICCAI-BraTS2023-GLI-Challenge-TrainingData/BraTS-GLI-01186-000/BraTS-GLI-01186-000-t1n.nii.gz,../../DataSet/ASNR-MICCAI-BraTS2023-GLI-Challenge-TrainingData/BraTS-GLI-01186-000/BraTS-GLI-01186-000-seg.nii.gz,88,145,110,65,109,127,168,88,136,44,41,48
00061-000,../../DataSet/ASNR-MICCAI-BraTS2023-GLI-Challenge-TrainingData/BraTS-GLI-00061-000/BraTS-GLI-00061-000-t1c.nii.gz,../../DataSet/ASNR-MICCAI-BraTS2023-GLI-Challenge-TrainingData/BraTS-GLI-00061-000/BraTS-GLI-00061-000-t2w.nii.gz,../../DataSet/ASNR-MICCAI-BraTS2023-GLI-Challenge-TrainingData/BraTS-GLI-00061-000/BraTS-GLI-00061-000-t2f.nii.gz,../../DataSet/ASNR-MICCAI-BraTS2023-GLI-Challenge-TrainingData/BraTS-GLI-00061-000/BraTS-GLI-00061-000-t1n.nii.gz,../../DataSet/ASNR-MICCAI-BraTS2023-GLI-Challenge-TrainingData/BraTS-GLI-00061-000/BraTS-GLI-00061-000-seg.nii.gz,147,131,53,129,167,85,157,34,75,38,72,41
00400-000,../../DataSet/ASNR-MICCAI-BraTS2023-GLI-Challenge-TrainingData/BraTS-GLI-00400-000/BraTS-GLI-00400-000-t1c.nii.gz,../../DataSet/ASNR-MICCAI-BraTS2023-GLI-Challenge-TrainingData/BraTS-GLI-00400-000/BraTS-GLI-00400-000-t2w.nii.gz,../../DataSet/ASNR-MICCAI-BraTS2023-GLI-Challenge-TrainingData/BraTS-GLI-00400-000/BraTS-GLI-00400-000-t2f.nii.gz,../../DataSet/ASNR-MICCAI-BraTS2023-GLI-Challenge-TrainingData/BraTS-GLI-00400-000/BraTS-GLI-00400-000-t1n.nii.gz,../../DataSet/ASNR-MICCAI-BraTS2023-GLI-Challenge-TrainingData/BraTS-GLI-00400-000/BraTS-GLI-00400-000-seg.nii.gz,92,110,63,56,136,72,163,21,105,80,91,84
01240-000,../../DataSet/ASNR-MICCAI-BraTS2023-GLI-Challenge-TrainingData/BraTS-GLI-01240-000/BraTS-GLI-01240-000-t1c.nii.gz,../../DataSet/ASNR-MICCAI-BraTS2023-GLI-Challenge-TrainingData/BraTS-GLI-01240-000/BraTS-GLI-01240-000-t2w.nii.gz,../../DataSet/ASNR-MICCAI-BraTS2023-GLI-Challenge-TrainingData/BraTS-GLI-01240-000/BraTS-GLI-01240-000-t2f.nii.gz,../../DataSet/ASNR-MICCAI-BraTS2023-GLI-Challenge-TrainingData/BraTS-GLI-01240-000/BraTS-GLI-01240-000-t1n.nii.gz,../../DataSet/ASNR-MICCAI-BraTS2023-GLI-Challenge-TrainingData/BraTS-GLI-01240-000/BraTS-GLI-01240-000-seg.nii.gz,144,115,51,120,166,77,157,26,85,46,80,59
01291-000,../../DataSet/ASNR-MICCAI-BraTS2023-GLI-Challenge-TrainingData/BraTS-GLI-01291-000/BraTS-GLI-01291-000-t1c.nii.gz,../../DataSet/ASNR-MICCAI-BraTS2023-GLI-Challenge-TrainingData/BraTS-GLI-01291-000/BraTS-GLI-01291-000-t2w.nii.gz,../../DataSet/ASNR-MICCAI-BraTS2023-GLI-Challenge-TrainingData/BraTS-GLI-01291-000/BraTS-GLI-01291-000-t2f.nii.gz,../../DataSet/ASNR-MICCAI-BraTS2023-GLI-Challenge-TrainingData/BraTS-GLI-01291-000/BraTS-GLI-01291-000-t1n.nii.gz,../../DataSet/ASNR-MICCAI-BraTS2023-GLI-Challenge-TrainingData/BraTS-GLI-01291-000/BraTS-GLI-01291-000-seg.nii.gz,93,128,106,62,118,94,168,72,140,56,74,68
01536-000,../../DataSet/ASNR-MICCAI-BraTS2023-GLI-Challenge-TrainingData/BraTS-GLI-01536-000/BraTS-GLI-01536-000-t1c.nii.gz,../../DataSet/ASNR-MICCAI-BraTS2023-GLI-Challenge-TrainingData/BraTS-GLI-01536-000/BraTS-GLI-01536-000-t2w.nii.gz,../../DataSet/ASNR-MICCAI-BraTS2023-GLI-Challenge-TrainingData/BraTS-GLI-01536-000/BraTS-GLI-01536-000-t2f.nii.gz,../../DataSet/ASNR-MICCAI-BraTS2023-GLI-Challenge-TrainingData/BraTS-GLI-01536-000/BraTS-GLI-01536-000-t1n.nii.gz,../../DataSet/ASNR-MICCAI-BraTS2023-GLI-Challenge-TrainingData/BraTS-GLI-01536-000/BraTS-GLI-01536-000-seg.nii.gz,164,134,52,130,184,99,176,33,76,54,77,43
00376-000,../../DataSet/ASNR-MICCAI-BraTS2023-GLI-Challenge-TrainingData/BraTS-GLI-00376-000/BraTS-GLI-00376-000-t1c.nii.gz,../../DataSet/ASNR-MICCAI-BraTS2023-GLI-Challenge-TrainingData/BraTS-GLI-00376-000/BraTS-GLI-00376-000-t2w.nii.gz,../../DataSet/ASNR-MICCAI-BraTS2023-GLI-Challenge-TrainingData/BraTS-GLI-00376-000/BraTS-GLI-00376-000-t2f.nii.gz,../../DataSet/ASNR-MICCAI-BraTS2023-GLI-Challenge-TrainingData/BraTS-GLI-00376-000/BraTS-GLI-00376-000-t1n.nii.gz,../../DataSet/ASNR-MICCAI-BraTS2023-GLI-Challenge-TrainingData/BraTS-GLI-00376-000/BraTS-GLI-00376-000-seg.nii.gz,158,157,97,132,183,133,186,75,124,51,53,49
01412-000,../../DataSet/ASNR-MICCAI-BraTS2023-GLI-Challenge-TrainingData/BraTS-GLI-01412-000/BraTS-GLI-01412-000-t1c.nii.gz,../../DataSet/ASNR-MICCAI-BraTS2023-GLI-Challenge-TrainingData/BraTS-GLI-01412-000/BraTS-GLI-01412-000-t2w.nii.gz,../../DataSet/ASNR-MICCAI-BraTS2023-GLI-Challenge-TrainingData/BraTS-GLI-01412-000/BraTS-GLI-01412-000-t2f.nii.gz,../../DataSet/ASNR-MICCAI-BraTS2023-GLI-Challenge-TrainingData/BraTS-GLI-01412-000/BraTS-GLI-01412-000-t1n.nii.gz,../../DataSet/ASNR-MICCAI-BraTS2023-GLI-Challenge-TrainingData/BraTS-GLI-01412-000/BraTS-GLI-01412-000-seg.nii.gz,140,169,98,118,164,140,202,68,128,46,62,60
00016-001,../../DataSet/ASNR-MICCAI-BraTS2023-GLI-Challenge-TrainingData/BraTS-GLI-00016-001/BraTS-GLI-00016-001-t1c.nii.gz,../../DataSet/ASNR-MICCAI-BraTS2023-GLI-Challenge-TrainingData/BraTS-GLI-00016-001/BraTS-GLI-00016-001-t2w.nii.gz,../../DataSet/ASNR-MICCAI-BraTS2023-GLI-Challenge-TrainingData/BraTS-GLI-00016-001/BraTS-GLI-00016-001-t2f.nii.gz,../../DataSet/ASNR-MICCAI-BraTS2023-GLI-Challenge-TrainingData/BraTS-GLI-00016-001/BraTS-GLI-00016-001-t1n.nii.gz,../../DataSet/ASNR-MICCAI-BraTS2023-GLI-Challenge-TrainingData/BraTS-GLI-00016-001/BraTS-GLI-00016-001-seg.nii.gz,150,174,70,126,184,134,204,41,108,58,70,67
00194-000,../../DataSet/ASNR-MICCAI-BraTS2023-GLI-Challenge-TrainingData/BraTS-GLI-00194-000/BraTS-GLI-00194-000-t1c.nii.gz,../../DataSet/ASNR-MICCAI-BraTS2023-GLI-Challenge-TrainingData/BraTS-GLI-00194-000/BraTS-GLI-00194-000-t2w.nii.gz,../../DataSet/ASNR-MICCAI-BraTS2023-GLI-Challenge-TrainingData/BraTS-GLI-00194-000/BraTS-GLI-00194-000-t2f.nii.gz,../../DataSet/ASNR-MICCAI-BraTS2023-GLI-Challenge-TrainingData/BraTS-GLI-00194-000/BraTS-GLI-00194-000-t1n.nii.gz,../../DataSet/ASNR-MICCAI-BraTS2023-GLI-Challenge-TrainingData/BraTS-GLI-00194-000/BraTS-GLI-00194-000-seg.nii.gz,94,151,61,76,115,110,194,40,90,39,84,50
01073-000,../../DataSet/ASNR-MICCAI-BraTS2023-GLI-Challenge-TrainingData/BraTS-GLI-01073-000/BraTS-GLI-01073-000-t1c.nii.gz,../../DataSet/ASNR-MICCAI-BraTS2023-GLI-Challenge-TrainingData/BraTS-GLI-01073-000/BraTS-GLI-01073-000-t2w.nii.gz,../../DataSet/ASNR-MICCAI-BraTS2023-GLI-Challenge-TrainingData/BraTS-GLI-01073-000/BraTS-GLI-01073-000-t2f.nii.gz,../../DataSet/ASNR-MICCAI-BraTS2023-GLI-Challenge-TrainingData/BraTS-GLI-01073-000/BraTS-GLI-01073-000-t1n.nii.gz,../../DataSet/ASNR-MICCAI-BraTS2023-GLI-Challenge-TrainingData/BraTS-GLI-01073-000/BraTS-GLI-01073-000-seg.nii.gz,140,165,89,118,171,127,205,55,135,53,78,80
00524-000,../../DataSet/ASNR-MICCAI-BraTS2023-GLI-Challenge-TrainingData/BraTS-GLI-00524-000/BraTS-GLI-00524-000-t1c.nii.gz,../../DataSet/ASNR-MICCAI-BraTS2023-GLI-Challenge-TrainingData/BraTS-GLI-00524-000/BraTS-GLI-00524-000-t2w.nii.gz,../../DataSet/ASNR-MICCAI-BraTS2023-GLI-Challenge-TrainingData/BraTS-GLI-00524-000/BraTS-GLI-00524-000-t2f.nii.gz,../../DataSet/ASNR-MICCAI-BraTS2023-GLI-Challenge-TrainingData/BraTS-GLI-00524-000/BraTS-GLI-00524-000-t1n.nii.gz,../../DataSet/ASNR-MICCAI-BraTS2023-GLI-Challenge-TrainingData/BraTS-GLI-00524-000/BraTS-GLI-00524-000-seg.nii.gz,83,134,64,61,132,93,169,36,96,71,76,60
00220-000,../../DataSet/ASNR-MICCAI-BraTS2023-GLI-Challenge-TrainingData/BraTS-GLI-00220-000/BraTS-GLI-00220-000-t1c.nii.gz,../../DataSet/ASNR-MICCAI-BraTS2023-GLI-Challenge-TrainingData/BraTS-GLI-00220-000/BraTS-GLI-00220-000-t2w.nii.gz,../../DataSet/ASNR-MICCAI-BraTS2023-GLI-Challenge-TrainingData/BraTS-GLI-00220-000/BraTS-GLI-00220-000-t2f.nii.gz,../../DataSet/ASNR-MICCAI-BraTS2023-GLI-Challenge-TrainingData/BraTS-GLI-00220-000/BraTS-GLI-00220-000-t1n.nii.gz,../../DataSet/ASNR-MICCAI-BraTS2023-GLI-Challenge-TrainingData/BraTS-GLI-00220-000/BraTS-GLI-00220-000-seg.nii.gz,76,117,85,59,97,96,145,57,115,38,49,58
01460-000,../../DataSet/ASNR-MICCAI-BraTS2023-GLI-Challenge-TrainingData/BraTS-GLI-01460-000/BraTS-GLI-01460-000-t1c.nii.gz,../../DataSet/ASNR-MICCAI-BraTS2023-GLI-Challenge-TrainingData/BraTS-GLI-01460-000/BraTS-GLI-01460-000-t2w.nii.gz,../../DataSet/ASNR-MICCAI-BraTS2023-GLI-Challenge-TrainingData/BraTS-GLI-01460-000/BraTS-GLI-01460-000-t2f.nii.gz,../../DataSet/ASNR-MICCAI-BraTS2023-GLI-Challenge-TrainingData/BraTS-GLI-01460-000/BraTS-GLI-01460-000-t1n.nii.gz,../../DataSet/ASNR-MICCAI-BraTS2023-GLI-Challenge-TrainingData/BraTS-GLI-01460-000/BraTS-GLI-01460-000-seg.nii.gz,151,114,63,118,181,78,164,31,98,63,86,67
01001-000,../../DataSet/ASNR-MICCAI-BraTS2023-GLI-Challenge-TrainingData/BraTS-GLI-01001-000/BraTS-GLI-01001-000-t1c.nii.gz,../../DataSet/ASNR-MICCAI-BraTS2023-GLI-Challenge-TrainingData/BraTS-GLI-01001-000/BraTS-GLI-01001-000-t2w.nii.gz,../../DataSet/ASNR-MICCAI-BraTS2023-GLI-Challenge-TrainingData/BraTS-GLI-01001-000/BraTS-GLI-01001-000-t2f.nii.gz,../../DataSet/ASNR-MICCAI-BraTS2023-GLI-Challenge-TrainingData/BraTS-GLI-01001-000/BraTS-GLI-01001-000-t1n.nii.gz,../../DataSet/ASNR-MICCAI-BraTS2023-GLI-Challenge-TrainingData/BraTS-GLI-01001-000/BraTS-GLI-01001-000-seg.nii.gz,136,122,70,69,158,101,148,51,99,89,47,48
00641-000,../../DataSet/ASNR-MICCAI-BraTS2023-GLI-Challenge-TrainingData/BraTS-GLI-00641-000/BraTS-GLI-00641-000-t1c.nii.gz,../../DataSet/ASNR-MICCAI-BraTS2023-GLI-Challenge-TrainingData/BraTS-GLI-00641-000/BraTS-GLI-00641-000-t2w.nii.gz,../../DataSet/ASNR-MICCAI-BraTS2023-GLI-Challenge-TrainingData/BraTS-GLI-00641-000/BraTS-GLI-00641-000-t2f.nii.gz,../../DataSet/ASNR-MICCAI-BraTS2023-GLI-Challenge-TrainingData/BraTS-GLI-00641-000/BraTS-GLI-00641-000-t1n.nii.gz,../../DataSet/ASNR-MICCAI-BraTS2023-GLI-Challenge-TrainingData/BraTS-GLI-00641-000/BraTS-GLI-00641-000-seg.nii.gz,79,140,91,60,103,114,167,73,112,43,53,39
00690-000,../../DataSet/ASNR-MICCAI-BraTS2023-GLI-Challenge-TrainingData/BraTS-GLI-00690-000/BraTS-GLI-00690-000-t1c.nii.gz,../../DataSet/ASNR-MICCAI-BraTS2023-GLI-Challenge-TrainingData/BraTS-GLI-00690-000/BraTS-GLI-00690-000-t2w.nii.gz,../../DataSet/ASNR-MICCAI-BraTS2023-GLI-Challenge-TrainingData/BraTS-GLI-00690-000/BraTS-GLI-00690-000-t2f.nii.gz,../../DataSet/ASNR-MICCAI-BraTS2023-GLI-Challenge-TrainingData/BraTS-GLI-00690-000/BraTS-GLI-00690-000-t1n.nii.gz,../../DataSet/ASNR-MICCAI-BraTS2023-GLI-Challenge-TrainingData/BraTS-GLI-00690-000/BraTS-GLI-00690-000-seg.nii.gz,150,97,106,131,173,55,129,82,131,42,74,49
00556-000,../../DataSet/ASNR-MICCAI-BraTS2023-GLI-Challenge-TrainingData/BraTS-GLI-00556-000/BraTS-GLI-00556-000-t1c.nii.gz,../../DataSet/ASNR-MICCAI-BraTS2023-GLI-Challenge-TrainingData/BraTS-GLI-00556-000/BraTS-GLI-00556-000-t2w.nii.gz,../../DataSet/ASNR-MICCAI-BraTS2023-GLI-Challenge-TrainingData/BraTS-GLI-00556-000/BraTS-GLI-00556-000-t2f.nii.gz,../../DataSet/ASNR-MICCAI-BraTS2023-GLI-Challenge-TrainingData/BraTS-GLI-00556-000/BraTS-GLI-00556-000-t1n.nii.gz,../../DataSet/ASNR-MICCAI-BraTS2023-GLI-Challenge-TrainingData/BraTS-GLI-00556-000/BraTS-GLI-00556-000-seg.nii.gz,77,148,93,53,107,100,194,65,123,54,94,58
00378-000,../../DataSet/ASNR-MICCAI-BraTS2023-GLI-Challenge-TrainingData/BraTS-GLI-00378-000/BraTS-GLI-00378-000-t1c.nii.gz,../../DataSet/ASNR-MICCAI-BraTS2023-GLI-Challenge-TrainingData/BraTS-GLI-00378-000/BraTS-GLI-00378-000-t2w.nii.gz,../../DataSet/ASNR-MICCAI-BraTS2023-GLI-Challenge-TrainingData/BraTS-GLI-00378-000/BraTS-GLI-00378-000-t2f.nii.gz,../../DataSet/ASNR-MICCAI-BraTS2023-GLI-Challenge-TrainingData/BraTS-GLI-00378-000/BraTS-GLI-00378-000-t1n.nii.gz,../../DataSet/ASNR-MICCAI-BraTS2023-GLI-Challenge-TrainingData/BraTS-GLI-00378-000/BraTS-GLI-00378-000-seg.nii.gz,151,110,48,132,173,88,147,25,78,41,59,53
01159-000,../../DataSet/ASNR-MICCAI-BraTS2023-GLI-Challenge-TrainingData/BraTS-GLI-01159-000/BraTS-GLI-01159-000-t1c.nii.gz,../../DataSet/ASNR-MICCAI-BraTS2023-GLI-Challenge-TrainingData/BraTS-GLI-01159-000/BraTS-GLI-01159-000-t2w.nii.gz,../../DataSet/ASNR-MICCAI-BraTS2023-GLI-Challenge-TrainingData/BraTS-GLI-01159-000/BraTS-GLI-01159-000-t2f.nii.gz,../../DataSet/ASNR-MICCAI-BraTS2023-GLI-Challenge-TrainingData/BraTS-GLI-01159-000/BraTS-GLI-01159-000-t1n.nii.gz,../../DataSet/ASNR-MICCAI-BraTS2023-GLI-Challenge-TrainingData/BraTS-GLI-01159-000/BraTS-GLI-01159-000-seg.nii.gz,148,138,95,88,178,82,173,49,123,90,91,74
00479-001,../../DataSet/ASNR-MICCAI-BraTS2023-GLI-Challenge-TrainingData/BraTS-GLI-00479-001/BraTS-GLI-00479-001-t1c.nii.gz,../../DataSet/ASNR-MICCAI-BraTS2023-GLI-Challenge-TrainingData/BraTS-GLI-00479-001/BraTS-GLI-00479-001-t2w.nii.gz,../../DataSet/ASNR-MICCAI-BraTS2023-GLI-Challenge-TrainingData/BraTS-GLI-00479-001/BraTS-GLI-00479-001-t2f.nii.gz,../../DataSet/ASNR-MICCAI-BraTS2023-GLI-Challenge-TrainingData/BraTS-GLI-00479-001/BraTS-GLI-00479-001-t1n.nii.gz,../../DataSet/ASNR-MICCAI-BraTS2023-GLI-Challenge-TrainingData/BraTS-GLI-00479-001/BraTS-GLI-00479-001-seg.nii.gz,88,122,86,62,115,91,155,56,117,53,64,61
00636-001,../../DataSet/ASNR-MICCAI-BraTS2023-GLI-Challenge-TrainingData/BraTS-GLI-00636-001/BraTS-GLI-00636-001-t1c.nii.gz,../../DataSet/ASNR-MICCAI-BraTS2023-GLI-Challenge-TrainingData/BraTS-GLI-00636-001/BraTS-GLI-00636-001-t2w.nii.gz,../../DataSet/ASNR-MICCAI-BraTS2023-GLI-Challenge-TrainingData/BraTS-GLI-00636-001/BraTS-GLI-00636-001-t2f.nii.gz,../../DataSet/ASNR-MICCAI-BraTS2023-GLI-Challenge-TrainingData/BraTS-GLI-00636-001/BraTS-GLI-00636-001-t1n.nii.gz,../../DataSet/ASNR-MICCAI-BraTS2023-GLI-Challenge-TrainingData/BraTS-GLI-00636-001/BraTS-GLI-00636-001-seg.nii.gz,162,113,81,141,181,93,133,55,100,40,40,45
00800-000,../../DataSet/ASNR-MICCAI-BraTS2023-GLI-Challenge-TrainingData/BraTS-GLI-00800-000/BraTS-GLI-00800-000-t1c.nii.gz,../../DataSet/ASNR-MICCAI-BraTS2023-GLI-Challenge-TrainingData/BraTS-GLI-00800-000/BraTS-GLI-00800-000-t2w.nii.gz,../../DataSet/ASNR-MICCAI-BraTS2023-GLI-Challenge-TrainingData/BraTS-GLI-00800-000/BraTS-GLI-00800-000-t2f.nii.gz,../../DataSet/ASNR-MICCAI-BraTS2023-GLI-Challenge-TrainingData/BraTS-GLI-00800-000/BraTS-GLI-00800-000-t1n.nii.gz,../../DataSet/ASNR-MICCAI-BraTS2023-GLI-Challenge-TrainingData/BraTS-GLI-00800-000/BraTS-GLI-00800-000-seg.nii.gz,143,178,67,121,164,145,202,44,91,43,57,47
00472-000,../../DataSet/ASNR-MICCAI-BraTS2023-GLI-Challenge-TrainingData/BraTS-GLI-00472-000/BraTS-GLI-00472-000-t1c.nii.gz,../../DataSet/ASNR-MICCAI-BraTS2023-GLI-Challenge-TrainingData/BraTS-GLI-00472-000/BraTS-GLI-00472-000-t2w.nii.gz,../../DataSet/ASNR-MICCAI-BraTS2023-GLI-Challenge-TrainingData/BraTS-GLI-00472-000/BraTS-GLI-00472-000-t2f.nii.gz,../../DataSet/ASNR-MICCAI-BraTS2023-GLI-Challenge-TrainingData/BraTS-GLI-00472-000/BraTS-GLI-00472-000-t1n.nii.gz,../../DataSet/ASNR-MICCAI-BraTS2023-GLI-Challenge-TrainingData/BraTS-GLI-00472-000/BraTS-GLI-00472-000-seg.nii.gz,157,119,56,132,184,80,166,25,87,52,86,62
00014-000,../../DataSet/ASNR-MICCAI-BraTS2023-GLI-Challenge-TrainingData/BraTS-GLI-00014-000/BraTS-GLI-00014-000-t1c.nii.gz,../../DataSet/ASNR-MICCAI-BraTS2023-GLI-Challenge-TrainingData/BraTS-GLI-00014-000/BraTS-GLI-00014-000-t2w.nii.gz,../../DataSet/ASNR-MICCAI-BraTS2023-GLI-Challenge-TrainingData/BraTS-GLI-00014-000/BraTS-GLI-00014-000-t2f.nii.gz,../../DataSet/ASNR-MICCAI-BraTS2023-GLI-Challenge-TrainingData/BraTS-GLI-00014-000/BraTS-GLI-00014-000-t1n.nii.gz,../../DataSet/ASNR-MICCAI-BraTS2023-GLI-Challenge-TrainingData/BraTS-GLI-00014-000/BraTS-GLI-00014-000-seg.nii.gz,151,117,38,132,171,91,151,14,64,39,60,50
00807-000,../../DataSet/ASNR-MICCAI-BraTS2023-GLI-Challenge-TrainingData/BraTS-GLI-00807-000/BraTS-GLI-00807-000-t1c.nii.gz,../../DataSet/ASNR-MICCAI-BraTS2023-GLI-Challenge-TrainingData/BraTS-GLI-00807-000/BraTS-GLI-00807-000-t2w.nii.gz,../../DataSet/ASNR-MICCAI-BraTS2023-GLI-Challenge-TrainingData/BraTS-GLI-00807-000/BraTS-GLI-00807-000-t2f.nii.gz,../../DataSet/ASNR-MICCAI-BraTS2023-GLI-Challenge-TrainingData/BraTS-GLI-00807-000/BraTS-GLI-00807-000-t1n.nii.gz,../../DataSet/ASNR-MICCAI-BraTS2023-GLI-Challenge-TrainingData/BraTS-GLI-00807-000/BraTS-GLI-00807-000-seg.nii.gz,85,163,67,53,132,116,211,33,107,79,95,74
01235-000,../../DataSet/ASNR-MICCAI-BraTS2023-GLI-Challenge-TrainingData/BraTS-GLI-01235-000/BraTS-GLI-01235-000-t1c.nii.gz,../../DataSet/ASNR-MICCAI-BraTS2023-GLI-Challenge-TrainingData/BraTS-GLI-01235-000/BraTS-GLI-01235-000-t2w.nii.gz,../../DataSet/ASNR-MICCAI-BraTS2023-GLI-Challenge-TrainingData/BraTS-GLI-01235-000/BraTS-GLI-01235-000-t2f.nii.gz,../../DataSet/ASNR-MICCAI-BraTS2023-GLI-Challenge-TrainingData/BraTS-GLI-01235-000/BraTS-GLI-01235-000-t1n.nii.gz,../../DataSet/ASNR-MICCAI-BraTS2023-GLI-Challenge-TrainingData/BraTS-GLI-01235-000/BraTS-GLI-01235-000-seg.nii.gz,87,119,99,56,115,79,159,68,135,59,80,67
00303-000,../../DataSet/ASNR-MICCAI-BraTS2023-GLI-Challenge-TrainingData/BraTS-GLI-00303-000/BraTS-GLI-00303-000-t1c.nii.gz,../../DataSet/ASNR-MICCAI-BraTS2023-GLI-Challenge-TrainingData/BraTS-GLI-00303-000/BraTS-GLI-00303-000-t2w.nii.gz,../../DataSet/ASNR-MICCAI-BraTS2023-GLI-Challenge-TrainingData/BraTS-GLI-00303-000/BraTS-GLI-00303-000-t2f.nii.gz,../../DataSet/ASNR-MICCAI-BraTS2023-GLI-Challenge-TrainingData/BraTS-GLI-00303-000/BraTS-GLI-00303-000-t1n.nii.gz,../../DataSet/ASNR-MICCAI-BraTS2023-GLI-Challenge-TrainingData/BraTS-GLI-00303-000/BraTS-GLI-00303-000-seg.nii.gz,155,168,60,126,186,120,207,29,99,60,87,70
01122-000,../../DataSet/ASNR-MICCAI-BraTS2023-GLI-Challenge-TrainingData/BraTS-GLI-01122-000/BraTS-GLI-01122-000-t1c.nii.gz,../../DataSet/ASNR-MICCAI-BraTS2023-GLI-Challenge-TrainingData/BraTS-GLI-01122-000/BraTS-GLI-01122-000-t2w.nii.gz,../../DataSet/ASNR-MICCAI-BraTS2023-GLI-Challenge-TrainingData/BraTS-GLI-01122-000/BraTS-GLI-01122-000-t2f.nii.gz,../../DataSet/ASNR-MICCAI-BraTS2023-GLI-Challenge-TrainingData/BraTS-GLI-01122-000/BraTS-GLI-01122-000-t1n.nii.gz,../../DataSet/ASNR-MICCAI-BraTS2023-GLI-Challenge-TrainingData/BraTS-GLI-01122-000/BraTS-GLI-01122-000-seg.nii.gz,97,109,104,63,135,66,149,64,144,72,83,80
00227-000,../../DataSet/ASNR-MICCAI-BraTS2023-GLI-Challenge-TrainingData/BraTS-GLI-00227-000/BraTS-GLI-00227-000-t1c.nii.gz,../../DataSet/ASNR-MICCAI-BraTS2023-GLI-Challenge-TrainingData/BraTS-GLI-00227-000/BraTS-GLI-00227-000-t2w.nii.gz,../../DataSet/ASNR-MICCAI-BraTS2023-GLI-Challenge-TrainingData/BraTS-GLI-00227-000/BraTS-GLI-00227-000-t2f.nii.gz,../../DataSet/ASNR-MICCAI-BraTS2023-GLI-Challenge-TrainingData/BraTS-GLI-00227-000/BraTS-GLI-00227-000-t1n.nii.gz,../../DataSet/ASNR-MICCAI-BraTS2023-GLI-Challenge-TrainingData/BraTS-GLI-00227-000/BraTS-GLI-00227-000-seg.nii.gz,160,114,50,130,183,84,155,27,76,53,71,49
00646-000,../../DataSet/ASNR-MICCAI-BraTS2023-GLI-Challenge-TrainingData/BraTS-GLI-00646-000/BraTS-GLI-00646-000-t1c.nii.gz,../../DataSet/ASNR-MICCAI-BraTS2023-GLI-Challenge-TrainingData/BraTS-GLI-00646-000/BraTS-GLI-00646-000-t2w.nii.gz,../../DataSet/ASNR-MICCAI-BraTS2023-GLI-Challenge-TrainingData/BraTS-GLI-00646-000/BraTS-GLI-00646-000-t2f.nii.gz,../../DataSet/ASNR-MICCAI-BraTS2023-GLI-Challenge-TrainingData/BraTS-GLI-00646-000/BraTS-GLI-00646-000-t1n.nii.gz,../../DataSet/ASNR-MICCAI-BraTS2023-GLI-Challenge-TrainingData/BraTS-GLI-00646-000/BraTS-GLI-00646-000-seg.nii.gz,99,94,99,66,130,49,143,63,138,64,94,75
00715-001,../../DataSet/ASNR-MICCAI-BraTS2023-GLI-Challenge-TrainingData/BraTS-GLI-00715-001/BraTS-GLI-00715-001-t1c.nii.gz,../../DataSet/ASNR-MICCAI-BraTS2023-GLI-Challenge-TrainingData/BraTS-GLI-00715-001/BraTS-GLI-00715-001-t2w.nii.gz,../../DataSet/ASNR-MICCAI-BraTS2023-GLI-Challenge-TrainingData/BraTS-GLI-00715-001/BraTS-GLI-00715-001-t2f.nii.gz,../../DataSet/ASNR-MICCAI-BraTS2023-GLI-Challenge-TrainingData/BraTS-GLI-00715-001/BraTS-GLI-00715-001-t1n.nii.gz,../../DataSet/ASNR-MICCAI-BraTS2023-GLI-Challenge-TrainingData/BraTS-GLI-00715-001/BraTS-GLI-00715-001-seg.nii.gz,133,146,107,114,160,106,187,51,144,46,81,93
00551-000,../../DataSet/ASNR-MICCAI-BraTS2023-GLI-Challenge-TrainingData/BraTS-GLI-00551-000/BraTS-GLI-00551-000-t1c.nii.gz,../../DataSet/ASNR-MICCAI-BraTS2023-GLI-Challenge-TrainingData/BraTS-GLI-00551-000/BraTS-GLI-00551-000-t2w.nii.gz,../../DataSet/ASNR-MICCAI-BraTS2023-GLI-Challenge-TrainingData/BraTS-GLI-00551-000/BraTS-GLI-00551-000-t2f.nii.gz,../../DataSet/ASNR-MICCAI-BraTS2023-GLI-Challenge-TrainingData/BraTS-GLI-00551-000/BraTS-GLI-00551-000-t1n.nii.gz,../../DataSet/ASNR-MICCAI-BraTS2023-GLI-Challenge-TrainingData/BraTS-GLI-00551-000/BraTS-GLI-00551-000-seg.nii.gz,138,175,60,102,171,135,206,24,99,69,71,75
00068-000,../../DataSet/ASNR-MICCAI-BraTS2023-GLI-Challenge-TrainingData/BraTS-GLI-00068-000/BraTS-GLI-00068-000-t1c.nii.gz,../../DataSet/ASNR-MICCAI-BraTS2023-GLI-Challenge-TrainingData/BraTS-GLI-00068-000/BraTS-GLI-00068-000-t2w.nii.gz,../../DataSet/ASNR-MICCAI-BraTS2023-GLI-Challenge-TrainingData/BraTS-GLI-00068-000/BraTS-GLI-00068-000-t2f.nii.gz,../../DataSet/ASNR-MICCAI-BraTS2023-GLI-Challenge-TrainingData/BraTS-GLI-00068-000/BraTS-GLI-00068-000-t1n.nii.gz,../../DataSet/ASNR-MICCAI-BraTS2023-GLI-Challenge-TrainingData/BraTS-GLI-00068-000/BraTS-GLI-00068-000-seg.nii.gz,94,124,64,65,146,76,166,28,106,81,90,78
00409-000,../../DataSet/ASNR-MICCAI-BraTS2023-GLI-Challenge-TrainingData/BraTS-GLI-00409-000/BraTS-GLI-00409-000-t1c.nii.gz,../../DataSet/ASNR-MICCAI-BraTS2023-GLI-Challenge-TrainingData/BraTS-GLI-00409-000/BraTS-GLI-00409-000-t2w.nii.gz,../../DataSet/ASNR-MICCAI-BraTS2023-GLI-Challenge-TrainingData/BraTS-GLI-00409-000/BraTS-GLI-00409-000-t2f.nii.gz,../../DataSet/ASNR-MICCAI-BraTS2023-GLI-Challenge-TrainingData/BraTS-GLI-00409-000/BraTS-GLI-00409-000-t1n.nii.gz,../../DataSet/ASNR-MICCAI-BraTS2023-GLI-Challenge-TrainingData/BraTS-GLI-00409-000/BraTS-GLI-00409-000-seg.nii.gz,155,126,58,129,182,82,176,24,102,53,94,78
01298-000,../../DataSet/ASNR-MICCAI-BraTS2023-GLI-Challenge-TrainingData/BraTS-GLI-01298-000/BraTS-GLI-01298-000-t1c.nii.gz,../../DataSet/ASNR-MICCAI-BraTS2023-GLI-Challenge-TrainingData/BraTS-GLI-01298-000/BraTS-GLI-01298-000-t2w.nii.gz,../../DataSet/ASNR-MICCAI-BraTS2023-GLI-Challenge-TrainingData/BraTS-GLI-01298-000/BraTS-GLI-01298-000-t2f.nii.gz,../../DataSet/ASNR-MICCAI-BraTS2023-GLI-Challenge-TrainingData/BraTS-GLI-01298-000/BraTS-GLI-01298-000-t1n.nii.gz,../../DataSet/ASNR-MICCAI-BraTS2023-GLI-Challenge-TrainingData/BraTS-GLI-01298-000/BraTS-GLI-01298-000-seg.nii.gz,100,107,108,70,124,65,149,84,135,54,84,51
00518-000,../../DataSet/ASNR-MICCAI-BraTS2023-GLI-Challenge-TrainingData/BraTS-GLI-00518-000/BraTS-GLI-00518-000-t1c.nii.gz,../../DataSet/ASNR-MICCAI-BraTS2023-GLI-Challenge-TrainingData/BraTS-GLI-00518-000/BraTS-GLI-00518-000-t2w.nii.gz,../../DataSet/ASNR-MICCAI-BraTS2023-GLI-Challenge-TrainingData/BraTS-GLI-00518-000/BraTS-GLI-00518-000-t2f.nii.gz,../../DataSet/ASNR-MICCAI-BraTS2023-GLI-Challenge-TrainingData/BraTS-GLI-00518-000/BraTS-GLI-00518-000-t1n.nii.gz,../../DataSet/ASNR-MICCAI-BraTS2023-GLI-Challenge-TrainingData/BraTS-GLI-00518-000/BraTS-GLI-00518-000-seg.nii.gz,155,97,80,131,178,65,132,56,102,47,67,46
01389-000,../../DataSet/ASNR-MICCAI-BraTS2023-GLI-Challenge-TrainingData/BraTS-GLI-01389-000/BraTS-GLI-01389-000-t1c.nii.gz,../../DataSet/ASNR-MICCAI-BraTS2023-GLI-Challenge-TrainingData/BraTS-GLI-01389-000/BraTS-GLI-01389-000-t2w.nii.gz,../../DataSet/ASNR-MICCAI-BraTS2023-GLI-Challenge-TrainingData/BraTS-GLI-01389-000/BraTS-GLI-01389-000-t2f.nii.gz,../../DataSet/ASNR-MICCAI-BraTS2023-GLI-Challenge-TrainingData/BraTS-GLI-01389-000/BraTS-GLI-01389-000-t1n.nii.gz,../../DataSet/ASNR-MICCAI-BraTS2023-GLI-Challenge-TrainingData/BraTS-GLI-01389-000/BraTS-GLI-01389-000-seg.nii.gz,166,155,47,137,185,132,181,4,67,48,49,63
00757-000,../../DataSet/ASNR-MICCAI-BraTS2023-GLI-Challenge-TrainingData/BraTS-GLI-00757-000/BraTS-GLI-00757-000-t1c.nii.gz,../../DataSet/ASNR-MICCAI-BraTS2023-GLI-Challenge-TrainingData/BraTS-GLI-00757-000/BraTS-GLI-00757-000-t2w.nii.gz,../../DataSet/ASNR-MICCAI-BraTS2023-GLI-Challenge-TrainingData/BraTS-GLI-00757-000/BraTS-GLI-00757-000-t2f.nii.gz,../../DataSet/ASNR-MICCAI-BraTS2023-GLI-Challenge-TrainingData/BraTS-GLI-00757-000/BraTS-GLI-00757-000-t1n.nii.gz,../../DataSet/ASNR-MICCAI-BraTS2023-GLI-Challenge-TrainingData/BraTS-GLI-00757-000/BraTS-GLI-00757-000-seg.nii.gz,91,146,90,66,140,108,191,54,132,74,83,78
01117-000,../../DataSet/ASNR-MICCAI-BraTS2023-GLI-Challenge-TrainingData/BraTS-GLI-01117-000/BraTS-GLI-01117-000-t1c.nii.gz,../../DataSet/ASNR-MICCAI-BraTS2023-GLI-Challenge-TrainingData/BraTS-GLI-01117-000/BraTS-GLI-01117-000-t2w.nii.gz,../../DataSet/ASNR-MICCAI-BraTS2023-GLI-Challenge-TrainingData/BraTS-GLI-01117-000/BraTS-GLI-01117-000-t2f.nii.gz,../../DataSet/ASNR-MICCAI-BraTS2023-GLI-Challenge-TrainingData/BraTS-GLI-01117-000/BraTS-GLI-01117-000-t1n.nii.gz,../../DataSet/ASNR-MICCAI-BraTS2023-GLI-Challenge-TrainingData/BraTS-GLI-01117-000/BraTS-GLI-01117-000-seg.nii.gz,79,148,96,59,107,116,167,76,119,48,51,43
00336-000,../../DataSet/ASNR-MICCAI-BraTS2023-GLI-Challenge-TrainingData/BraTS-GLI-00336-000/BraTS-GLI-00336-000-t1c.nii.gz,../../DataSet/ASNR-MICCAI-BraTS2023-GLI-Challenge-TrainingData/BraTS-GLI-00336-000/BraTS-GLI-00336-000-t2w.nii.gz,../../DataSet/ASNR-MICCAI-BraTS2023-GLI-Challenge-TrainingData/BraTS-GLI-00336-000/BraTS-GLI-00336-000-t2f.nii.gz,../../DataSet/ASNR-MICCAI-BraTS2023-GLI-Challenge-TrainingData/BraTS-GLI-00336-000/BraTS-GLI-00336-000-t1n.nii.gz,../../DataSet/ASNR-MICCAI-BraTS2023-GLI-Challenge-TrainingData/BraTS-GLI-00336-000/BraTS-GLI-00336-000-seg.nii.gz,144,90,85,110,179,45,137,53,126,69,92,73
00491-000,../../DataSet/ASNR-MICCAI-BraTS2023-GLI-Challenge-TrainingData/BraTS-GLI-00491-000/BraTS-GLI-00491-000-t1c.nii.gz,../../DataSet/ASNR-MICCAI-BraTS2023-GLI-Challenge-TrainingData/BraTS-GLI-00491-000/BraTS-GLI-00491-000-t2w.nii.gz,../../DataSet/ASNR-MICCAI-BraTS2023-GLI-Challenge-TrainingData/BraTS-GLI-00491-000/BraTS-GLI-00491-000-t2f.nii.gz,../../DataSet/ASNR-MICCAI-BraTS2023-GLI-Challenge-TrainingData/BraTS-GLI-00491-000/BraTS-GLI-00491-000-t1n.nii.gz,../../DataSet/ASNR-MICCAI-BraTS2023-GLI-Challenge-TrainingData/BraTS-GLI-00491-000/BraTS-GLI-00491-000-seg.nii.gz,97,167,94,66,122,137,201,64,128,56,64,64
01200-000,../../DataSet/ASNR-MICCAI-BraTS2023-GLI-Challenge-TrainingData/BraTS-GLI-01200-000/BraTS-GLI-01200-000-t1c.nii.gz,../../DataSet/ASNR-MICCAI-BraTS2023-GLI-Challenge-TrainingData/BraTS-GLI-01200-000/BraTS-GLI-01200-000-t2w.nii.gz,../../DataSet/ASNR-MICCAI-BraTS2023-GLI-Challenge-TrainingData/BraTS-GLI-01200-000/BraTS-GLI-01200-000-t2f.nii.gz,../../DataSet/ASNR-MICCAI-BraTS2023-GLI-Challenge-TrainingData/BraTS-GLI-01200-000/BraTS-GLI-01200-000-t1n.nii.gz,../../DataSet/ASNR-MICCAI-BraTS2023-GLI-Challenge-TrainingData/BraTS-GLI-01200-000/BraTS-GLI-01200-000-seg.nii.gz,144,169,86,120,174,140,203,58,121,54,63,63
01661-000,../../DataSet/ASNR-MICCAI-BraTS2023-GLI-Challenge-TrainingData/BraTS-GLI-01661-000/BraTS-GLI-01661-000-t1c.nii.gz,../../DataSet/ASNR-MICCAI-BraTS2023-GLI-Challenge-TrainingData/BraTS-GLI-01661-000/BraTS-GLI-01661-000-t2w.nii.gz,../../DataSet/ASNR-MICCAI-BraTS2023-GLI-Challenge-TrainingData/BraTS-GLI-01661-000/BraTS-GLI-01661-000-t2f.nii.gz,../../DataSet/ASNR-MICCAI-BraTS2023-GLI-Challenge-TrainingData/BraTS-GLI-01661-000/BraTS-GLI-01661-000-t1n.nii.gz,../../DataSet/ASNR-MICCAI-BraTS2023-GLI-Challenge-TrainingData/BraTS-GLI-01661-000/BraTS-GLI-01661-000-seg.nii.gz,147,116,71,107,179,74,159,31,109,72,85,78
00021-000,../../DataSet/ASNR-MICCAI-BraTS2023-GLI-Challenge-TrainingData/BraTS-GLI-00021-000/BraTS-GLI-00021-000-t1c.nii.gz,../../DataSet/ASNR-MICCAI-BraTS2023-GLI-Challenge-TrainingData/BraTS-GLI-00021-000/BraTS-GLI-00021-000-t2w.nii.gz,../../DataSet/ASNR-MICCAI-BraTS2023-GLI-Challenge-TrainingData/BraTS-GLI-00021-000/BraTS-GLI-00021-000-t2f.nii.gz,../../DataSet/ASNR-MICCAI-BraTS2023-GLI-Challenge-TrainingData/BraTS-GLI-00021-000/BraTS-GLI-00021-000-t1n.nii.gz,../../DataSet/ASNR-MICCAI-BraTS2023-GLI-Challenge-TrainingData/BraTS-GLI-00021-000/BraTS-GLI-00021-000-seg.nii.gz,105,99,59,68,160,64,137,33,96,92,73,63
01483-000,../../DataSet/ASNR-MICCAI-BraTS2023-GLI-Challenge-TrainingData/BraTS-GLI-01483-000/BraTS-GLI-01483-000-t1c.nii.gz,../../DataSet/ASNR-MICCAI-BraTS2023-GLI-Challenge-TrainingData/BraTS-GLI-01483-000/BraTS-GLI-01483-000-t2w.nii.gz,../../DataSet/ASNR-MICCAI-BraTS2023-GLI-Challenge-TrainingData/BraTS-GLI-01483-000/BraTS-GLI-01483-000-t2f.nii.gz,../../DataSet/ASNR-MICCAI-BraTS2023-GLI-Challenge-TrainingData/BraTS-GLI-01483-000/BraTS-GLI-01483-000-t1n.nii.gz,../../DataSet/ASNR-MICCAI-BraTS2023-GLI-Challenge-TrainingData/BraTS-GLI-01483-000/BraTS-GLI-01483-000-seg.nii.gz,85,164,78,54,117,126,201,38,109,63,75,71
00105-000,../../DataSet/ASNR-MICCAI-BraTS2023-GLI-Challenge-TrainingData/BraTS-GLI-00105-000/BraTS-GLI-00105-000-t1c.nii.gz,../../DataSet/ASNR-MICCAI-BraTS2023-GLI-Challenge-TrainingData/BraTS-GLI-00105-000/BraTS-GLI-00105-000-t2w.nii.gz,../../DataSet/ASNR-MICCAI-BraTS2023-GLI-Challenge-TrainingData/BraTS-GLI-00105-000/BraTS-GLI-00105-000-t2f.nii.gz,../../DataSet/ASNR-MICCAI-BraTS2023-GLI-Challenge-TrainingData/BraTS-GLI-00105-000/BraTS-GLI-00105-000-t1n.nii.gz,../../DataSet/ASNR-MICCAI-BraTS2023-GLI-Challenge-TrainingData/BraTS-GLI-00105-000/BraTS-GLI-00105-000-seg.nii.gz,150,145,90,113,187,98,193,48,133,74,95,85
00087-001,../../DataSet/ASNR-MICCAI-BraTS2023-GLI-Challenge-TrainingData/BraTS-GLI-00087-001/BraTS-GLI-00087-001-t1c.nii.gz,../../DataSet/ASNR-MICCAI-BraTS2023-GLI-Challenge-TrainingData/BraTS-GLI-00087-001/BraTS-GLI-00087-001-t2w.nii.gz,../../DataSet/ASNR-MICCAI-BraTS2023-GLI-Challenge-TrainingData/BraTS-GLI-00087-001/BraTS-GLI-00087-001-t2f.nii.gz,../../DataSet/ASNR-MICCAI-BraTS2023-GLI-Challenge-TrainingData/BraTS-GLI-00087-001/BraTS-GLI-00087-001-t1n.nii.gz,../../DataSet/ASNR-MICCAI-BraTS2023-GLI-Challenge-TrainingData/BraTS-GLI-00087-001/BraTS-GLI-00087-001-seg.nii.gz,152,125,62,124,181,89,173,26,93,57,84,67
00056-001,../../DataSet/ASNR-MICCAI-BraTS2023-GLI-Challenge-TrainingData/BraTS-GLI-00056-001/BraTS-GLI-00056-001-t1c.nii.gz,../../DataSet/ASNR-MICCAI-BraTS2023-GLI-Challenge-TrainingData/BraTS-GLI-00056-001/BraTS-GLI-00056-001-t2w.nii.gz,../../DataSet/ASNR-MICCAI-BraTS2023-GLI-Challenge-TrainingData/BraTS-GLI-00056-001/BraTS-GLI-00056-001-t2f.nii.gz,../../DataSet/ASNR-MICCAI-BraTS2023-GLI-Challenge-TrainingData/BraTS-GLI-00056-001/BraTS-GLI-00056-001-t1n.nii.gz,../../DataSet/ASNR-MICCAI-BraTS2023-GLI-Challenge-TrainingData/BraTS-GLI-00056-001/BraTS-GLI-00056-001-seg.nii.gz,154,121,62,120,181,84,170,32,91,61,86,59
01033-000,../../DataSet/ASNR-MICCAI-BraTS2023-GLI-Challenge-TrainingData/BraTS-GLI-01033-000/BraTS-GLI-01033-000-t1c.nii.gz,../../DataSet/ASNR-MICCAI-BraTS2023-GLI-Challenge-TrainingData/BraTS-GLI-01033-000/BraTS-GLI-01033-000-t2w.nii.gz,../../DataSet/ASNR-MICCAI-BraTS2023-GLI-Challenge-TrainingData/BraTS-GLI-01033-000/BraTS-GLI-01033-000-t2f.nii.gz,../../DataSet/ASNR-MICCAI-BraTS2023-GLI-Challenge-TrainingData/BraTS-GLI-01033-000/BraTS-GLI-01033-000-t1n.nii.gz,../../DataSet/ASNR-MICCAI-BraTS2023-GLI-Challenge-TrainingData/BraTS-GLI-01033-000/BraTS-GLI-01033-000-seg.nii.gz,83,151,65,58,110,108,203,42,92,52,95,50
01452-000,../../DataSet/ASNR-MICCAI-BraTS2023-GLI-Challenge-TrainingData/BraTS-GLI-01452-000/BraTS-GLI-01452-000-t1c.nii.gz,../../DataSet/ASNR-MICCAI-BraTS2023-GLI-Challenge-TrainingData/BraTS-GLI-01452-000/BraTS-GLI-01452-000-t2w.nii.gz,../../DataSet/ASNR-MICCAI-BraTS2023-GLI-Challenge-TrainingData/BraTS-GLI-01452-000/BraTS-GLI-01452-000-t2f.nii.gz,../../DataSet/ASNR-MICCAI-BraTS2023-GLI-Challenge-TrainingData/BraTS-GLI-01452-000/BraTS-GLI-01452-000-t1n.nii.gz,../../DataSet/ASNR-MICCAI-BraTS2023-GLI-Challenge-TrainingData/BraTS-GLI-01452-000/BraTS-GLI-01452-000-seg.nii.gz,157,161,90,132,183,138,186,62,113,51,48,51
01484-000,../../DataSet/ASNR-MICCAI-BraTS2023-GLI-Challenge-TrainingData/BraTS-GLI-01484-000/BraTS-GLI-01484-000-t1c.nii.gz,../../DataSet/ASNR-MICCAI-BraTS2023-GLI-Challenge-TrainingData/BraTS-GLI-01484-000/BraTS-GLI-01484-000-t2w.nii.gz,../../DataSet/ASNR-MICCAI-BraTS2023-GLI-Challenge-TrainingData/BraTS-GLI-01484-000/BraTS-GLI-01484-000-t2f.nii.gz,../../DataSet/ASNR-MICCAI-BraTS2023-GLI-Challenge-TrainingData/BraTS-GLI-01484-000/BraTS-GLI-01484-000-t1n.nii.gz,../../DataSet/ASNR-MICCAI-BraTS2023-GLI-Challenge-TrainingData/BraTS-GLI-01484-000/BraTS-GLI-01484-000-seg.nii.gz,92,164,92,57,120,128,207,58,139,63,79,81
01323-000,../../DataSet/ASNR-MICCAI-BraTS2023-GLI-Challenge-TrainingData/BraTS-GLI-01323-000/BraTS-GLI-01323-000-t1c.nii.gz,../../DataSet/ASNR-MICCAI-BraTS2023-GLI-Challenge-TrainingData/BraTS-GLI-01323-000/BraTS-GLI-01323-000-t2w.nii.gz,../../DataSet/ASNR-MICCAI-BraTS2023-GLI-Challenge-TrainingData/BraTS-GLI-01323-000/BraTS-GLI-01323-000-t2f.nii.gz,../../DataSet/ASNR-MICCAI-BraTS2023-GLI-Challenge-TrainingData/BraTS-GLI-01323-000/BraTS-GLI-01323-000-t1n.nii.gz,../../DataSet/ASNR-MICCAI-BraTS2023-GLI-Challenge-TrainingData/BraTS-GLI-01323-000/BraTS-GLI-01323-000-seg.nii.gz,83,149,79,53,117,118,182,55,107,64,64,52
00563-000,../../DataSet/ASNR-MICCAI-BraTS2023-GLI-Challenge-TrainingData/BraTS-GLI-00563-000/BraTS-GLI-00563-000-t1c.nii.gz,../../DataSet/ASNR-MICCAI-BraTS2023-GLI-Challenge-TrainingData/BraTS-GLI-00563-000/BraTS-GLI-00563-000-t2w.nii.gz,../../DataSet/ASNR-MICCAI-BraTS2023-GLI-Challenge-TrainingData/BraTS-GLI-00563-000/BraTS-GLI-00563-000-t2f.nii.gz,../../DataSet/ASNR-MICCAI-BraTS2023-GLI-Challenge-TrainingData/BraTS-GLI-00563-000/BraTS-GLI-00563-000-t1n.nii.gz,../../DataSet/ASNR-MICCAI-BraTS2023-GLI-Challenge-TrainingData/BraTS-GLI-00563-000/BraTS-GLI-00563-000-seg.nii.gz,150,126,65,122,177,87,171,30,99,55,84,69
00102-000,../../DataSet/ASNR-MICCAI-BraTS2023-GLI-Challenge-TrainingData/BraTS-GLI-00102-000/BraTS-GLI-00102-000-t1c.nii.gz,../../DataSet/ASNR-MICCAI-BraTS2023-GLI-Challenge-TrainingData/BraTS-GLI-00102-000/BraTS-GLI-00102-000-t2w.nii.gz,../../DataSet/ASNR-MICCAI-BraTS2023-GLI-Challenge-TrainingData/BraTS-GLI-00102-000/BraTS-GLI-00102-000-t2f.nii.gz,../../DataSet/ASNR-MICCAI-BraTS2023-GLI-Challenge-TrainingData/BraTS-GLI-00102-000/BraTS-GLI-00102-000-t1n.nii.gz,../../DataSet/ASNR-MICCAI-BraTS2023-GLI-Challenge-TrainingData/BraTS-GLI-00102-000/BraTS-GLI-00102-000-seg.nii.gz,95,156,55,80,112,139,177,41,72,32,38,31
01034-000,../../DataSet/ASNR-MICCAI-BraTS2023-GLI-Challenge-TrainingData/BraTS-GLI-01034-000/BraTS-GLI-01034-000-t1c.nii.gz,../../DataSet/ASNR-MICCAI-BraTS2023-GLI-Challenge-TrainingData/BraTS-GLI-01034-000/BraTS-GLI-01034-000-t2w.nii.gz,../../DataSet/ASNR-MICCAI-BraTS2023-GLI-Challenge-TrainingData/BraTS-GLI-01034-000/BraTS-GLI-01034-000-t2f.nii.gz,../../DataSet/ASNR-MICCAI-BraTS2023-GLI-Challenge-TrainingData/BraTS-GLI-01034-000/BraTS-GLI-01034-000-t1n.nii.gz,../../DataSet/ASNR-MICCAI-BraTS2023-GLI-Challenge-TrainingData/BraTS-GLI-01034-000/BraTS-GLI-01034-000-seg.nii.gz,87,105,50,67,112,83,138,31,69,45,55,38
01048-000,../../DataSet/ASNR-MICCAI-BraTS2023-GLI-Challenge-TrainingData/BraTS-GLI-01048-000/BraTS-GLI-01048-000-t1c.nii.gz,../../DataSet/ASNR-MICCAI-BraTS2023-GLI-Challenge-TrainingData/BraTS-GLI-01048-000/BraTS-GLI-01048-000-t2w.nii.gz,../../DataSet/ASNR-MICCAI-BraTS2023-GLI-Challenge-TrainingData/BraTS-GLI-01048-000/BraTS-GLI-01048-000-t2f.nii.gz,../../DataSet/ASNR-MICCAI-BraTS2023-GLI-Challenge-TrainingData/BraTS-GLI-01048-000/BraTS-GLI-01048-000-t1n.nii.gz,../../DataSet/ASNR-MICCAI-BraTS2023-GLI-Challenge-TrainingData/BraTS-GLI-01048-000/BraTS-GLI-01048-000-seg.nii.gz,147,134,56,102,184,92,182,24,95,82,90,71
00608-000,../../DataSet/ASNR-MICCAI-BraTS2023-GLI-Challenge-TrainingData/BraTS-GLI-00608-000/BraTS-GLI-00608-000-t1c.nii.gz,../../DataSet/ASNR-MICCAI-BraTS2023-GLI-Challenge-TrainingData/BraTS-GLI-00608-000/BraTS-GLI-00608-000-t2w.nii.gz,../../DataSet/ASNR-MICCAI-BraTS2023-GLI-Challenge-TrainingData/BraTS-GLI-00608-000/BraTS-GLI-00608-000-t2f.nii.gz,../../DataSet/ASNR-MICCAI-BraTS2023-GLI-Challenge-TrainingData/BraTS-GLI-00608-000/BraTS-GLI-00608-000-t1n.nii.gz,../../DataSet/ASNR-MICCAI-BraTS2023-GLI-Challenge-TrainingData/BraTS-GLI-00608-000/BraTS-GLI-00608-000-seg.nii.gz,81,123,89,57,113,88,164,59,120,56,76,61
00269-000,../../DataSet/ASNR-MICCAI-BraTS2023-GLI-Challenge-TrainingData/BraTS-GLI-00269-000/BraTS-GLI-00269-000-t1c.nii.gz,../../DataSet/ASNR-MICCAI-BraTS2023-GLI-Challenge-TrainingData/BraTS-GLI-00269-000/BraTS-GLI-00269-000-t2w.nii.gz,../../DataSet/ASNR-MICCAI-BraTS2023-GLI-Challenge-TrainingData/BraTS-GLI-00269-000/BraTS-GLI-00269-000-t2f.nii.gz,../../DataSet/ASNR-MICCAI-BraTS2023-GLI-Challenge-TrainingData/BraTS-GLI-00269-000/BraTS-GLI-00269-000-t1n.nii.gz,../../DataSet/ASNR-MICCAI-BraTS2023-GLI-Challenge-TrainingData/BraTS-GLI-00269-000/BraTS-GLI-00269-000-seg.nii.gz,143,166,99,121,173,127,208,63,133,52,81,70
00750-000,../../DataSet/ASNR-MICCAI-BraTS2023-GLI-Challenge-TrainingData/BraTS-GLI-00750-000/BraTS-GLI-00750-000-t1c.nii.gz,../../DataSet/ASNR-MICCAI-BraTS2023-GLI-Challenge-TrainingData/BraTS-GLI-00750-000/BraTS-GLI-00750-000-t2w.nii.gz,../../DataSet/ASNR-MICCAI-BraTS2023-GLI-Challenge-TrainingData/BraTS-GLI-00750-000/BraTS-GLI-00750-000-t2f.nii.gz,../../DataSet/ASNR-MICCAI-BraTS2023-GLI-Challenge-TrainingData/BraTS-GLI-00750-000/BraTS-GLI-00750-000-t1n.nii.gz,../../DataSet/ASNR-MICCAI-BraTS2023-GLI-Challenge-TrainingData/BraTS-GLI-00750-000/BraTS-GLI-00750-000-seg.nii.gz,101,165,91,82,122,134,199,66,124,40,65,58
00496-000,../../DataSet/ASNR-MICCAI-BraTS2023-GLI-Challenge-TrainingData/BraTS-GLI-00496-000/BraTS-GLI-00496-000-t1c.nii.gz,../../DataSet/ASNR-MICCAI-BraTS2023-GLI-Challenge-TrainingData/BraTS-GLI-00496-000/BraTS-GLI-00496-000-t2w.nii.gz,../../DataSet/ASNR-MICCAI-BraTS2023-GLI-Challenge-TrainingData/BraTS-GLI-00496-000/BraTS-GLI-00496-000-t2f.nii.gz,../../DataSet/ASNR-MICCAI-BraTS2023-GLI-Challenge-TrainingData/BraTS-GLI-00496-000/BraTS-GLI-00496-000-t1n.nii.gz,../../DataSet/ASNR-MICCAI-BraTS2023-GLI-Challenge-TrainingData/BraTS-GLI-00496-000/BraTS-GLI-00496-000-seg.nii.gz,85,110,49,60,113,76,150,30,71,53,74,41
00331-000,../../DataSet/ASNR-MICCAI-BraTS2023-GLI-Challenge-TrainingData/BraTS-GLI-00331-000/BraTS-GLI-00331-000-t1c.nii.gz,../../DataSet/ASNR-MICCAI-BraTS2023-GLI-Challenge-TrainingData/BraTS-GLI-00331-000/BraTS-GLI-00331-000-t2w.nii.gz,../../DataSet/ASNR-MICCAI-BraTS2023-GLI-Challenge-TrainingData/BraTS-GLI-00331-000/BraTS-GLI-00331-000-t2f.nii.gz,../../DataSet/ASNR-MICCAI-BraTS2023-GLI-Challenge-TrainingData/BraTS-GLI-00331-000/BraTS-GLI-00331-000-t1n.nii.gz,../../DataSet/ASNR-MICCAI-BraTS2023-GLI-Challenge-TrainingData/BraTS-GLI-00331-000/BraTS-GLI-00331-000-seg.nii.gz,168,160,71,147,187,134,188,55,96,40,54,41
01207-000,../../DataSet/ASNR-MICCAI-BraTS2023-GLI-Challenge-TrainingData/BraTS-GLI-01207-000/BraTS-GLI-01207-000-t1c.nii.gz,../../DataSet/ASNR-MICCAI-BraTS2023-GLI-Challenge-TrainingData/BraTS-GLI-01207-000/BraTS-GLI-01207-000-t2w.nii.gz,../../DataSet/ASNR-MICCAI-BraTS2023-GLI-Challenge-TrainingData/BraTS-GLI-01207-000/BraTS-GLI-01207-000-t2f.nii.gz,../../DataSet/ASNR-MICCAI-BraTS2023-GLI-Challenge-TrainingData/BraTS-GLI-01207-000/BraTS-GLI-01207-000-t1n.nii.gz,../../DataSet/ASNR-MICCAI-BraTS2023-GLI-Challenge-TrainingData/BraTS-GLI-01207-000/BraTS-GLI-01207-000-seg.nii.gz,163,146,60,141,188,108,177,36,89,47,69,53
00026-000,../../DataSet/ASNR-MICCAI-BraTS2023-GLI-Challenge-TrainingData/BraTS-GLI-00026-000/BraTS-GLI-00026-000-t1c.nii.gz,../../DataSet/ASNR-MICCAI-BraTS2023-GLI-Challenge-TrainingData/BraTS-GLI-00026-000/BraTS-GLI-00026-000-t2w.nii.gz,../../DataSet/ASNR-MICCAI-BraTS2023-GLI-Challenge-TrainingData/BraTS-GLI-00026-000/BraTS-GLI-00026-000-t2f.nii.gz,../../DataSet/ASNR-MICCAI-BraTS2023-GLI-Challenge-TrainingData/BraTS-GLI-00026-000/BraTS-GLI-00026-000-t1n.nii.gz,../../DataSet/ASNR-MICCAI-BraTS2023-GLI-Challenge-TrainingData/BraTS-GLI-00026-000/BraTS-GLI-00026-000-seg.nii.gz,161,115,70,138,192,66,149,38,95,54,83,57
01666-000,../../DataSet/ASNR-MICCAI-BraTS2023-GLI-Challenge-TrainingData/BraTS-GLI-01666-000/BraTS-GLI-01666-000-t1c.nii.gz,../../DataSet/ASNR-MICCAI-BraTS2023-GLI-Challenge-TrainingData/BraTS-GLI-01666-000/BraTS-GLI-01666-000-t2w.nii.gz,../../DataSet/ASNR-MICCAI-BraTS2023-GLI-Challenge-TrainingData/BraTS-GLI-01666-000/BraTS-GLI-01666-000-t2f.nii.gz,../../DataSet/ASNR-MICCAI-BraTS2023-GLI-Challenge-TrainingData/BraTS-GLI-01666-000/BraTS-GLI-01666-000-t1n.nii.gz,../../DataSet/ASNR-MICCAI-BraTS2023-GLI-Challenge-TrainingData/BraTS-GLI-01666-000/BraTS-GLI-01666-000-seg.nii.gz,145,102,72,110,179,63,152,33,110,69,89,77
00729-001,../../DataSet/ASNR-MICCAI-BraTS2023-GLI-Challenge-TrainingData/BraTS-GLI-00729-001/BraTS-GLI-00729-001-t1c.nii.gz,../../DataSet/ASNR-MICCAI-BraTS2023-GLI-Challenge-TrainingData/BraTS-GLI-00729-001/BraTS-GLI-00729-001-t2w.nii.gz,../../DataSet/ASNR-MICCAI-BraTS2023-GLI-Challenge-TrainingData/BraTS-GLI-00729-001/BraTS-GLI-00729-001-t2f.nii.gz,../../DataSet/ASNR-MICCAI-BraTS2023-GLI-Challenge-TrainingData/BraTS-GLI-00729-001/BraTS-GLI-00729-001-t1n.nii.gz,../../DataSet/ASNR-MICCAI-BraTS2023-GLI-Challenge-TrainingData/BraTS-GLI-00729-001/BraTS-GLI-00729-001-seg.nii.gz,145,167,55,123,166,144,204,42,71,43,60,29
00085-000,../../DataSet/ASNR-MICCAI-BraTS2023-GLI-Challenge-TrainingData/BraTS-GLI-00085-000/BraTS-GLI-00085-000-t1c.nii.gz,../../DataSet/ASNR-MICCAI-BraTS2023-GLI-Challenge-TrainingData/BraTS-GLI-00085-000/BraTS-GLI-00085-000-t2w.nii.gz,../../DataSet/ASNR-MICCAI-BraTS2023-GLI-Challenge-TrainingData/BraTS-GLI-00085-000/BraTS-GLI-00085-000-t2f.nii.gz,../../DataSet/ASNR-MICCAI-BraTS2023-GLI-Challenge-TrainingData/BraTS-GLI-00085-000/BraTS-GLI-00085-000-t1n.nii.gz,../../DataSet/ASNR-MICCAI-BraTS2023-GLI-Challenge-TrainingData/BraTS-GLI-00085-000/BraTS-GLI-00085-000-seg.nii.gz,142,162,103,123,177,134,196,66,137,54,62,71
01162-000,../../DataSet/ASNR-MICCAI-BraTS2023-GLI-Challenge-TrainingData/BraTS-GLI-01162-000/BraTS-GLI-01162-000-t1c.nii.gz,../../DataSet/ASNR-MICCAI-BraTS2023-GLI-Challenge-TrainingData/BraTS-GLI-01162-000/BraTS-GLI-01162-000-t2w.nii.gz,../../DataSet/ASNR-MICCAI-BraTS2023-GLI-Challenge-TrainingData/BraTS-GLI-01162-000/BraTS-GLI-01162-000-t2f.nii.gz,../../DataSet/ASNR-MICCAI-BraTS2023-GLI-Challenge-TrainingData/BraTS-GLI-01162-000/BraTS-GLI-01162-000-t1n.nii.gz,../../DataSet/ASNR-MICCAI-BraTS2023-GLI-Challenge-TrainingData/BraTS-GLI-01162-000/BraTS-GLI-01162-000-seg.nii.gz,156,121,59,126,184,80,168,23,93,58,88,70
01503-000,../../DataSet/ASNR-MICCAI-BraTS2023-GLI-Challenge-TrainingData/BraTS-GLI-01503-000/BraTS-GLI-01503-000-t1c.nii.gz,../../DataSet/ASNR-MICCAI-BraTS2023-GLI-Challenge-TrainingData/BraTS-GLI-01503-000/BraTS-GLI-01503-000-t2w.nii.gz,../../DataSet/ASNR-MICCAI-BraTS2023-GLI-Challenge-TrainingData/BraTS-GLI-01503-000/BraTS-GLI-01503-000-t2f.nii.gz,../../DataSet/ASNR-MICCAI-BraTS2023-GLI-Challenge-TrainingData/BraTS-GLI-01503-000/BraTS-GLI-01503-000-t1n.nii.gz,../../DataSet/ASNR-MICCAI-BraTS2023-GLI-Challenge-TrainingData/BraTS-GLI-01503-000/BraTS-GLI-01503-000-seg.nii.gz,106,77,76,86,132,45,119,52,107,46,74,55
00343-000,../../DataSet/ASNR-MICCAI-BraTS2023-GLI-Challenge-TrainingData/BraTS-GLI-00343-000/BraTS-GLI-00343-000-t1c.nii.gz,../../DataSet/ASNR-MICCAI-BraTS2023-GLI-Challenge-TrainingData/BraTS-GLI-00343-000/BraTS-GLI-00343-000-t2w.nii.gz,../../DataSet/ASNR-MICCAI-BraTS2023-GLI-Challenge-TrainingData/BraTS-GLI-00343-000/BraTS-GLI-00343-000-t2f.nii.gz,../../DataSet/ASNR-MICCAI-BraTS2023-GLI-Challenge-TrainingData/BraTS-GLI-00343-000/BraTS-GLI-00343-000-t1n.nii.gz,../../DataSet/ASNR-MICCAI-BraTS2023-GLI-Challenge-TrainingData/BraTS-GLI-00343-000/BraTS-GLI-00343-000-seg.nii.gz,83,177,69,64,106,150,199,43,100,42,49,57
00392-000,../../DataSet/ASNR-MICCAI-BraTS2023-GLI-Challenge-TrainingData/BraTS-GLI-00392-000/BraTS-GLI-00392-000-t1c.nii.gz,../../DataSet/ASNR-MICCAI-BraTS2023-GLI-Challenge-TrainingData/BraTS-GLI-00392-000/BraTS-GLI-00392-000-t2w.nii.gz,../../DataSet/ASNR-MICCAI-BraTS2023-GLI-Challenge-TrainingData/BraTS-GLI-00392-000/BraTS-GLI-00392-000-t2f.nii.gz,../../DataSet/ASNR-MICCAI-BraTS2023-GLI-Challenge-TrainingData/BraTS-GLI-00392-000/BraTS-GLI-00392-000-t1n.nii.gz,../../DataSet/ASNR-MICCAI-BraTS2023-GLI-Challenge-TrainingData/BraTS-GLI-00392-000/BraTS-GLI-00392-000-seg.nii.gz,83,163,82,60,107,135,191,59,112,47,56,53
01275-000,../../DataSet/ASNR-MICCAI-BraTS2023-GLI-Challenge-TrainingData/BraTS-GLI-01275-000/BraTS-GLI-01275-000-t1c.nii.gz,../../DataSet/ASNR-MICCAI-BraTS2023-GLI-Challenge-TrainingData/BraTS-GLI-01275-000/BraTS-GLI-01275-000-t2w.nii.gz,../../DataSet/ASNR-MICCAI-BraTS2023-GLI-Challenge-TrainingData/BraTS-GLI-01275-000/BraTS-GLI-01275-000-t2f.nii.gz,../../DataSet/ASNR-MICCAI-BraTS2023-GLI-Challenge-TrainingData/BraTS-GLI-01275-000/BraTS-GLI-01275-000-t1n.nii.gz,../../DataSet/ASNR-MICCAI-BraTS2023-GLI-Challenge-TrainingData/BraTS-GLI-01275-000/BraTS-GLI-01275-000-seg.nii.gz,158,108,97,137,180,87,133,70,122,43,46,52
00054-000,../../DataSet/ASNR-MICCAI-BraTS2023-GLI-Challenge-TrainingData/BraTS-GLI-00054-000/BraTS-GLI-00054-000-t1c.nii.gz,../../DataSet/ASNR-MICCAI-BraTS2023-GLI-Challenge-TrainingData/BraTS-GLI-00054-000/BraTS-GLI-00054-000-t2w.nii.gz,../../DataSet/ASNR-MICCAI-BraTS2023-GLI-Challenge-TrainingData/BraTS-GLI-00054-000/BraTS-GLI-00054-000-t2f.nii.gz,../../DataSet/ASNR-MICCAI-BraTS2023-GLI-Challenge-TrainingData/BraTS-GLI-00054-000/BraTS-GLI-00054-000-t1n.nii.gz,../../DataSet/ASNR-MICCAI-BraTS2023-GLI-Challenge-TrainingData/BraTS-GLI-00054-000/BraTS-GLI-00054-000-seg.nii.gz,148,102,100,119,179,60,137,70,132,60,77,62
00511-000,../../DataSet/ASNR-MICCAI-BraTS2023-GLI-Challenge-TrainingData/BraTS-GLI-00511-000/BraTS-GLI-00511-000-t1c.nii.gz,../../DataSet/ASNR-MICCAI-BraTS2023-GLI-Challenge-TrainingData/BraTS-GLI-00511-000/BraTS-GLI-00511-000-t2w.nii.gz,../../DataSet/ASNR-MICCAI-BraTS2023-GLI-Challenge-TrainingData/BraTS-GLI-00511-000/BraTS-GLI-00511-000-t2f.nii.gz,../../DataSet/ASNR-MICCAI-BraTS2023-GLI-Challenge-TrainingData/BraTS-GLI-00511-000/BraTS-GLI-00511-000-t1n.nii.gz,../../DataSet/ASNR-MICCAI-BraTS2023-GLI-Challenge-TrainingData/BraTS-GLI-00511-000/BraTS-GLI-00511-000-seg.nii.gz,163,114,56,138,186,78,164,29,83,48,86,54
01351-000,../../DataSet/ASNR-MICCAI-BraTS2023-GLI-Challenge-TrainingData/BraTS-GLI-01351-000/BraTS-GLI-01351-000-t1c.nii.gz,../../DataSet/ASNR-MICCAI-BraTS2023-GLI-Challenge-TrainingData/BraTS-GLI-01351-000/BraTS-GLI-01351-000-t2w.nii.gz,../../DataSet/ASNR-MICCAI-BraTS2023-GLI-Challenge-TrainingData/BraTS-GLI-01351-000/BraTS-GLI-01351-000-t2f.nii.gz,../../DataSet/ASNR-MICCAI-BraTS2023-GLI-Challenge-TrainingData/BraTS-GLI-01351-000/BraTS-GLI-01351-000-t1n.nii.gz,../../DataSet/ASNR-MICCAI-BraTS2023-GLI-Challenge-TrainingData/BraTS-GLI-01351-000/BraTS-GLI-01351-000-seg.nii.gz,158,121,52,128,188,82,162,19,88,60,80,69
01097-000,../../DataSet/ASNR-MICCAI-BraTS2023-GLI-Challenge-TrainingData/BraTS-GLI-01097-000/BraTS-GLI-01097-000-t1c.nii.gz,../../DataSet/ASNR-MICCAI-BraTS2023-GLI-Challenge-TrainingData/BraTS-GLI-01097-000/BraTS-GLI-01097-000-t2w.nii.gz,../../DataSet/ASNR-MICCAI-BraTS2023-GLI-Challenge-TrainingData/BraTS-GLI-01097-000/BraTS-GLI-01097-000-t2f.nii.gz,../../DataSet/ASNR-MICCAI-BraTS2023-GLI-Challenge-TrainingData/BraTS-GLI-01097-000/BraTS-GLI-01097-000-t1n.nii.gz,../../DataSet/ASNR-MICCAI-BraTS2023-GLI-Challenge-TrainingData/BraTS-GLI-01097-000/BraTS-GLI-01097-000-seg.nii.gz,124,163,87,89,159,134,188,64,112,70,54,48
00170-000,../../DataSet/ASNR-MICCAI-BraTS2023-GLI-Challenge-TrainingData/BraTS-GLI-00170-000/BraTS-GLI-00170-000-t1c.nii.gz,../../DataSet/ASNR-MICCAI-BraTS2023-GLI-Challenge-TrainingData/BraTS-GLI-00170-000/BraTS-GLI-00170-000-t2w.nii.gz,../../DataSet/ASNR-MICCAI-BraTS2023-GLI-Challenge-TrainingData/BraTS-GLI-00170-000/BraTS-GLI-00170-000-t2f.nii.gz,../../DataSet/ASNR-MICCAI-BraTS2023-GLI-Challenge-TrainingData/BraTS-GLI-00170-000/BraTS-GLI-00170-000-t1n.nii.gz,../../DataSet/ASNR-MICCAI-BraTS2023-GLI-Challenge-TrainingData/BraTS-GLI-00170-000/BraTS-GLI-00170-000-seg.nii.gz,104,124,123,88,122,103,148,102,141,34,45,39
01046-000,../../DataSet/ASNR-MICCAI-BraTS2023-GLI-Challenge-TrainingData/BraTS-GLI-01046-000/BraTS-GLI-01046-000-t1c.nii.gz,../../DataSet/ASNR-MICCAI-BraTS2023-GLI-Challenge-TrainingData/BraTS-GLI-01046-000/BraTS-GLI-01046-000-t2w.nii.gz,../../DataSet/ASNR-MICCAI-BraTS2023-GLI-Challenge-TrainingData/BraTS-GLI-01046-000/BraTS-GLI-01046-000-t2f.nii.gz,../../DataSet/ASNR-MICCAI-BraTS2023-GLI-Challenge-TrainingData/BraTS-GLI-01046-000/BraTS-GLI-01046-000-t1n.nii.gz,../../DataSet/ASNR-MICCAI-BraTS2023-GLI-Challenge-TrainingData/BraTS-GLI-01046-000/BraTS-GLI-01046-000-seg.nii.gz,139,174,99,117,167,139,212,70,135,50,73,65
01427-000,../../DataSet/ASNR-MICCAI-BraTS2023-GLI-Challenge-TrainingData/BraTS-GLI-01427-000/BraTS-GLI-01427-000-t1c.nii.gz,../../DataSet/ASNR-MICCAI-BraTS2023-GLI-Challenge-TrainingData/BraTS-GLI-01427-000/BraTS-GLI-01427-000-t2w.nii.gz,../../DataSet/ASNR-MICCAI-BraTS2023-GLI-Challenge-TrainingData/BraTS-GLI-01427-000/BraTS-GLI-01427-000-t2f.nii.gz,../../DataSet/ASNR-MICCAI-BraTS2023-GLI-Challenge-TrainingData/BraTS-GLI-01427-000/BraTS-GLI-01427-000-t1n.nii.gz,../../DataSet/ASNR-MICCAI-BraTS2023-GLI-Challenge-TrainingData/BraTS-GLI-01427-000/BraTS-GLI-01427-000-seg.nii.gz,81,130,68,53,119,90,183,40,99,66,93,59
00267-000,../../DataSet/ASNR-MICCAI-BraTS2023-GLI-Challenge-TrainingData/BraTS-GLI-00267-000/BraTS-GLI-00267-000-t1c.nii.gz,../../DataSet/ASNR-MICCAI-BraTS2023-GLI-Challenge-TrainingData/BraTS-GLI-00267-000/BraTS-GLI-00267-000-t2w.nii.gz,../../DataSet/ASNR-MICCAI-BraTS2023-GLI-Challenge-TrainingData/BraTS-GLI-00267-000/BraTS-GLI-00267-000-t2f.nii.gz,../../DataSet/ASNR-MICCAI-BraTS2023-GLI-Challenge-TrainingData/BraTS-GLI-00267-000/BraTS-GLI-00267-000-t1n.nii.gz,../../DataSet/ASNR-MICCAI-BraTS2023-GLI-Challenge-TrainingData/BraTS-GLI-00267-000/BraTS-GLI-00267-000-seg.nii.gz,151,112,76,124,183,72,161,33,112,59,89,79
00498-000,../../DataSet/ASNR-MICCAI-BraTS2023-GLI-Challenge-TrainingData/BraTS-GLI-00498-000/BraTS-GLI-00498-000-t1c.nii.gz,../../DataSet/ASNR-MICCAI-BraTS2023-GLI-Challenge-TrainingData/BraTS-GLI-00498-000/BraTS-GLI-00498-000-t2w.nii.gz,../../DataSet/ASNR-MICCAI-BraTS2023-GLI-Challenge-TrainingData/BraTS-GLI-00498-000/BraTS-GLI-00498-000-t2f.nii.gz,../../DataSet/ASNR-MICCAI-BraTS2023-GLI-Challenge-TrainingData/BraTS-GLI-00498-000/BraTS-GLI-00498-000-t1n.nii.gz,../../DataSet/ASNR-MICCAI-BraTS2023-GLI-Challenge-TrainingData/BraTS-GLI-00498-000/BraTS-GLI-00498-000-seg.nii.gz,159,113,63,129,187,76,156,33,101,58,80,68
00028-000,../../DataSet/ASNR-MICCAI-BraTS2023-GLI-Challenge-TrainingData/BraTS-GLI-00028-000/BraTS-GLI-00028-000-t1c.nii.gz,../../DataSet/ASNR-MICCAI-BraTS2023-GLI-Challenge-TrainingData/BraTS-GLI-00028-000/BraTS-GLI-00028-000-t2w.nii.gz,../../DataSet/ASNR-MICCAI-BraTS2023-GLI-Challenge-TrainingData/BraTS-GLI-00028-000/BraTS-GLI-00028-000-t2f.nii.gz,../../DataSet/ASNR-MICCAI-BraTS2023-GLI-Challenge-TrainingData/BraTS-GLI-00028-000/BraTS-GLI-00028-000-t1n.nii.gz,../../DataSet/ASNR-MICCAI-BraTS2023-GLI-Challenge-TrainingData/BraTS-GLI-00028-000/BraTS-GLI-00028-000-seg.nii.gz,154,106,73,130,177,85,129,46,98,47,44,52
01356-000,../../DataSet/ASNR-MICCAI-BraTS2023-GLI-Challenge-TrainingData/BraTS-GLI-01356-000/BraTS-GLI-01356-000-t1c.nii.gz,../../DataSet/ASNR-MICCAI-BraTS2023-GLI-Challenge-TrainingData/BraTS-GLI-01356-000/BraTS-GLI-01356-000-t2w.nii.gz,../../DataSet/ASNR-MICCAI-BraTS2023-GLI-Challenge-TrainingData/BraTS-GLI-01356-000/BraTS-GLI-01356-000-t2f.nii.gz,../../DataSet/ASNR-MICCAI-BraTS2023-GLI-Challenge-TrainingData/BraTS-GLI-01356-000/BraTS-GLI-01356-000-t1n.nii.gz,../../DataSet/ASNR-MICCAI-BraTS2023-GLI-Challenge-TrainingData/BraTS-GLI-01356-000/BraTS-GLI-01356-000-seg.nii.gz,85,120,60,57,115,80,166,26,95,58,86,69
00177-000,../../DataSet/ASNR-MICCAI-BraTS2023-GLI-Challenge-TrainingData/BraTS-GLI-00177-000/BraTS-GLI-00177-000-t1c.nii.gz,../../DataSet/ASNR-MICCAI-BraTS2023-GLI-Challenge-TrainingData/BraTS-GLI-00177-000/BraTS-GLI-00177-000-t2w.nii.gz,../../DataSet/ASNR-MICCAI-BraTS2023-GLI-Challenge-TrainingData/BraTS-GLI-00177-000/BraTS-GLI-00177-000-t2f.nii.gz,../../DataSet/ASNR-MICCAI-BraTS2023-GLI-Challenge-TrainingData/BraTS-GLI-00177-000/BraTS-GLI-00177-000-t1n.nii.gz,../../DataSet/ASNR-MICCAI-BraTS2023-GLI-Challenge-TrainingData/BraTS-GLI-00177-000/BraTS-GLI-00177-000-seg.nii.gz,80,124,65,48,123,83,165,32,99,75,82,67
01090-000,../../DataSet/ASNR-MICCAI-BraTS2023-GLI-Challenge-TrainingData/BraTS-GLI-01090-000/BraTS-GLI-01090-000-t1c.nii.gz,../../DataSet/ASNR-MICCAI-BraTS2023-GLI-Challenge-TrainingData/BraTS-GLI-01090-000/BraTS-GLI-01090-000-t2w.nii.gz,../../DataSet/ASNR-MICCAI-BraTS2023-GLI-Challenge-TrainingData/BraTS-GLI-01090-000/BraTS-GLI-01090-000-t2f.nii.gz,../../DataSet/ASNR-MICCAI-BraTS2023-GLI-Challenge-TrainingData/BraTS-GLI-01090-000/BraTS-GLI-01090-000-t1n.nii.gz,../../DataSet/ASNR-MICCAI-BraTS2023-GLI-Challenge-TrainingData/BraTS-GLI-01090-000/BraTS-GLI-01090-000-seg.nii.gz,151,91,79,128,174,64,134,48,118,46,70,70
00601-000,../../DataSet/ASNR-MICCAI-BraTS2023-GLI-Challenge-TrainingData/BraTS-GLI-00601-000/BraTS-GLI-00601-000-t1c.nii.gz,../../DataSet/ASNR-MICCAI-BraTS2023-GLI-Challenge-TrainingData/BraTS-GLI-00601-000/BraTS-GLI-00601-000-t2w.nii.gz,../../DataSet/ASNR-MICCAI-BraTS2023-GLI-Challenge-TrainingData/BraTS-GLI-00601-000/BraTS-GLI-00601-000-t2f.nii.gz,../../DataSet/ASNR-MICCAI-BraTS2023-GLI-Challenge-TrainingData/BraTS-GLI-00601-000/BraTS-GLI-00601-000-t1n.nii.gz,../../DataSet/ASNR-MICCAI-BraTS2023-GLI-Challenge-TrainingData/BraTS-GLI-00601-000/BraTS-GLI-00601-000-seg.nii.gz,83,113,53,55,114,77,152,25,82,59,75,57
00024-001,../../DataSet/ASNR-MICCAI-BraTS2023-GLI-Challenge-TrainingData/BraTS-GLI-00024-001/BraTS-GLI-00024-001-t1c.nii.gz,../../DataSet/ASNR-MICCAI-BraTS2023-GLI-Challenge-TrainingData/BraTS-GLI-00024-001/BraTS-GLI-00024-001-t2w.nii.gz,../../DataSet/ASNR-MICCAI-BraTS2023-GLI-Challenge-TrainingData/BraTS-GLI-00024-001/BraTS-GLI-00024-001-t2f.nii.gz,../../DataSet/ASNR-MICCAI-BraTS2023-GLI-Challenge-TrainingData/BraTS-GLI-00024-001/BraTS-GLI-00024-001-t1n.nii.gz,../../DataSet/ASNR-MICCAI-BraTS2023-GLI-Challenge-TrainingData/BraTS-GLI-00024-001/BraTS-GLI-00024-001-seg.nii.gz,160,123,46,131,185,91,162,23,76,54,71,53
00260-000,../../DataSet/ASNR-MICCAI-BraTS2023-GLI-Challenge-TrainingData/BraTS-GLI-00260-000/BraTS-GLI-00260-000-t1c.nii.gz,../../DataSet/ASNR-MICCAI-BraTS2023-GLI-Challenge-TrainingData/BraTS-GLI-00260-000/BraTS-GLI-00260-000-t2w.nii.gz,../../DataSet/ASNR-MICCAI-BraTS2023-GLI-Challenge-TrainingData/BraTS-GLI-00260-000/BraTS-GLI-00260-000-t2f.nii.gz,../../DataSet/ASNR-MICCAI-BraTS2023-GLI-Challenge-TrainingData/BraTS-GLI-00260-000/BraTS-GLI-00260-000-t1n.nii.gz,../../DataSet/ASNR-MICCAI-BraTS2023-GLI-Challenge-TrainingData/BraTS-GLI-00260-000/BraTS-GLI-00260-000-seg.nii.gz,106,120,106,71,138,77,162,75,139,67,85,64
01420-000,../../DataSet/ASNR-MICCAI-BraTS2023-GLI-Challenge-TrainingData/BraTS-GLI-01420-000/BraTS-GLI-01420-000-t1c.nii.gz,../../DataSet/ASNR-MICCAI-BraTS2023-GLI-Challenge-TrainingData/BraTS-GLI-01420-000/BraTS-GLI-01420-000-t2w.nii.gz,../../DataSet/ASNR-MICCAI-BraTS2023-GLI-Challenge-TrainingData/BraTS-GLI-01420-000/BraTS-GLI-01420-000-t2f.nii.gz,../../DataSet/ASNR-MICCAI-BraTS2023-GLI-Challenge-TrainingData/BraTS-GLI-01420-000/BraTS-GLI-01420-000-t1n.nii.gz,../../DataSet/ASNR-MICCAI-BraTS2023-GLI-Challenge-TrainingData/BraTS-GLI-01420-000/BraTS-GLI-01420-000-seg.nii.gz,153,170,89,134,176,149,196,71,111,42,47,40
01119-000,../../DataSet/ASNR-MICCAI-BraTS2023-GLI-Challenge-TrainingData/BraTS-GLI-01119-000/BraTS-GLI-01119-000-t1c.nii.gz,../../DataSet/ASNR-MICCAI-BraTS2023-GLI-Challenge-TrainingData/BraTS-GLI-01119-000/BraTS-GLI-01119-000-t2w.nii.gz,../../DataSet/ASNR-MICCAI-BraTS2023-GLI-Challenge-TrainingData/BraTS-GLI-01119-000/BraTS-GLI-01119-000-t2f.nii.gz,../../DataSet/ASNR-MICCAI-BraTS2023-GLI-Challenge-TrainingData/BraTS-GLI-01119-000/BraTS-GLI-01119-000-t1n.nii.gz,../../DataSet/ASNR-MICCAI-BraTS2023-GLI-Challenge-TrainingData/BraTS-GLI-01119-000/BraTS-GLI-01119-000-seg.nii.gz,133,162,32,111,163,140,185,12,61,52,45,49
00759-000,../../DataSet/ASNR-MICCAI-BraTS2023-GLI-Challenge-TrainingData/BraTS-GLI-00759-000/BraTS-GLI-00759-000-t1c.nii.gz,../../DataSet/ASNR-MICCAI-BraTS2023-GLI-Challenge-TrainingData/BraTS-GLI-00759-000/BraTS-GLI-00759-000-t2w.nii.gz,../../DataSet/ASNR-MICCAI-BraTS2023-GLI-Challenge-TrainingData/BraTS-GLI-00759-000/BraTS-GLI-00759-000-t2f.nii.gz,../../DataSet/ASNR-MICCAI-BraTS2023-GLI-Challenge-TrainingData/BraTS-GLI-00759-000/BraTS-GLI-00759-000-t1n.nii.gz,../../DataSet/ASNR-MICCAI-BraTS2023-GLI-Challenge-TrainingData/BraTS-GLI-00759-000/BraTS-GLI-00759-000-seg.nii.gz,79,147,79,53,111,97,187,44,114,58,90,70
00338-000,../../DataSet/ASNR-MICCAI-BraTS2023-GLI-Challenge-TrainingData/BraTS-GLI-00338-000/BraTS-GLI-00338-000-t1c.nii.gz,../../DataSet/ASNR-MICCAI-BraTS2023-GLI-Challenge-TrainingData/BraTS-GLI-00338-000/BraTS-GLI-00338-000-t2w.nii.gz,../../DataSet/ASNR-MICCAI-BraTS2023-GLI-Challenge-TrainingData/BraTS-GLI-00338-000/BraTS-GLI-00338-000-t2f.nii.gz,../../DataSet/ASNR-MICCAI-BraTS2023-GLI-Challenge-TrainingData/BraTS-GLI-00338-000/BraTS-GLI-00338-000-t1n.nii.gz,../../DataSet/ASNR-MICCAI-BraTS2023-GLI-Challenge-TrainingData/BraTS-GLI-00338-000/BraTS-GLI-00338-000-seg.nii.gz,153,158,67,123,183,108,203,33,112,60,95,79
00788-000,../../DataSet/ASNR-MICCAI-BraTS2023-GLI-Challenge-TrainingData/BraTS-GLI-00788-000/BraTS-GLI-00788-000-t1c.nii.gz,../../DataSet/ASNR-MICCAI-BraTS2023-GLI-Challenge-TrainingData/BraTS-GLI-00788-000/BraTS-GLI-00788-000-t2w.nii.gz,../../DataSet/ASNR-MICCAI-BraTS2023-GLI-Challenge-TrainingData/BraTS-GLI-00788-000/BraTS-GLI-00788-000-t2f.nii.gz,../../DataSet/ASNR-MICCAI-BraTS2023-GLI-Challenge-TrainingData/BraTS-GLI-00788-000/BraTS-GLI-00788-000-t1n.nii.gz,../../DataSet/ASNR-MICCAI-BraTS2023-GLI-Challenge-TrainingData/BraTS-GLI-00788-000/BraTS-GLI-00788-000-seg.nii.gz,153,103,48,135,175,83,129,28,65,40,46,37
00058-001,../../DataSet/ASNR-MICCAI-BraTS2023-GLI-Challenge-TrainingData/BraTS-GLI-00058-001/BraTS-GLI-00058-001-t1c.nii.gz,../../DataSet/ASNR-MICCAI-BraTS2023-GLI-Challenge-TrainingData/BraTS-GLI-00058-001/BraTS-GLI-00058-001-t2w.nii.gz,../../DataSet/ASNR-MICCAI-BraTS2023-GLI-Challenge-TrainingData/BraTS-GLI-00058-001/BraTS-GLI-00058-001-t2f.nii.gz,../../DataSet/ASNR-MICCAI-BraTS2023-GLI-Challenge-TrainingData/BraTS-GLI-00058-001/BraTS-GLI-00058-001-t1n.nii.gz,../../DataSet/ASNR-MICCAI-BraTS2023-GLI-Challenge-TrainingData/BraTS-GLI-00058-001/BraTS-GLI-00058-001-seg.nii.gz,148,166,57,90,174,131,195,8,85,84,64,77
00725-000,../../DataSet/ASNR-MICCAI-BraTS2023-GLI-Challenge-TrainingData/BraTS-GLI-00725-000/BraTS-GLI-00725-000-t1c.nii.gz,../../DataSet/ASNR-MICCAI-BraTS2023-GLI-Challenge-TrainingData/BraTS-GLI-00725-000/BraTS-GLI-00725-000-t2w.nii.gz,../../DataSet/ASNR-MICCAI-BraTS2023-GLI-Challenge-TrainingData/BraTS-GLI-00725-000/BraTS-GLI-00725-000-t2f.nii.gz,../../DataSet/ASNR-MICCAI-BraTS2023-GLI-Challenge-TrainingData/BraTS-GLI-00725-000/BraTS-GLI-00725-000-t1n.nii.gz,../../DataSet/ASNR-MICCAI-BraTS2023-GLI-Challenge-TrainingData/BraTS-GLI-00725-000/BraTS-GLI-00725-000-seg.nii.gz,128,92,87,89,173,54,140,58,115,84,86,57
00344-000,../../DataSet/ASNR-MICCAI-BraTS2023-GLI-Challenge-TrainingData/BraTS-GLI-00344-000/BraTS-GLI-00344-000-t1c.nii.gz,../../DataSet/ASNR-MICCAI-BraTS2023-GLI-Challenge-TrainingData/BraTS-GLI-00344-000/BraTS-GLI-00344-000-t2w.nii.gz,../../DataSet/ASNR-MICCAI-BraTS2023-GLI-Challenge-TrainingData/BraTS-GLI-00344-000/BraTS-GLI-00344-000-t2f.nii.gz,../../DataSet/ASNR-MICCAI-BraTS2023-GLI-Challenge-TrainingData/BraTS-GLI-00344-000/BraTS-GLI-00344-000-t1n.nii.gz,../../DataSet/ASNR-MICCAI-BraTS2023-GLI-Challenge-TrainingData/BraTS-GLI-00344-000/BraTS-GLI-00344-000-seg.nii.gz,87,115,55,66,109,84,161,33,74,43,77,41
01504-000,../../DataSet/ASNR-MICCAI-BraTS2023-GLI-Challenge-TrainingData/BraTS-GLI-01504-000/BraTS-GLI-01504-000-t1c.nii.gz,../../DataSet/ASNR-MICCAI-BraTS2023-GLI-Challenge-TrainingData/BraTS-GLI-01504-000/BraTS-GLI-01504-000-t2w.nii.gz,../../DataSet/ASNR-MICCAI-BraTS2023-GLI-Challenge-TrainingData/BraTS-GLI-01504-000/BraTS-GLI-01504-000-t2f.nii.gz,../../DataSet/ASNR-MICCAI-BraTS2023-GLI-Challenge-TrainingData/BraTS-GLI-01504-000/BraTS-GLI-01504-000-t1n.nii.gz,../../DataSet/ASNR-MICCAI-BraTS2023-GLI-Challenge-TrainingData/BraTS-GLI-01504-000/BraTS-GLI-01504-000-seg.nii.gz,158,129,89,127,186,94,167,57,123,59,73,66
01272-000,../../DataSet/ASNR-MICCAI-BraTS2023-GLI-Challenge-TrainingData/BraTS-GLI-01272-000/BraTS-GLI-01272-000-t1c.nii.gz,../../DataSet/ASNR-MICCAI-BraTS2023-GLI-Challenge-TrainingData/BraTS-GLI-01272-000/BraTS-GLI-01272-000-t2w.nii.gz,../../DataSet/ASNR-MICCAI-BraTS2023-GLI-Challenge-TrainingData/BraTS-GLI-01272-000/BraTS-GLI-01272-000-t2f.nii.gz,../../DataSet/ASNR-MICCAI-BraTS2023-GLI-Challenge-TrainingData/BraTS-GLI-01272-000/BraTS-GLI-01272-000-t1n.nii.gz,../../DataSet/ASNR-MICCAI-BraTS2023-GLI-Challenge-TrainingData/BraTS-GLI-01272-000/BraTS-GLI-01272-000-seg.nii.gz,161,123,64,134,184,87,167,38,89,50,80,51
00432-000,../../DataSet/ASNR-MICCAI-BraTS2023-GLI-Challenge-TrainingData/BraTS-GLI-00432-000/BraTS-GLI-00432-000-t1c.nii.gz,../../DataSet/ASNR-MICCAI-BraTS2023-GLI-Challenge-TrainingData/BraTS-GLI-00432-000/BraTS-GLI-00432-000-t2w.nii.gz,../../DataSet/ASNR-MICCAI-BraTS2023-GLI-Challenge-TrainingData/BraTS-GLI-00432-000/BraTS-GLI-00432-000-t2f.nii.gz,../../DataSet/ASNR-MICCAI-BraTS2023-GLI-Challenge-TrainingData/BraTS-GLI-00432-000/BraTS-GLI-00432-000-t1n.nii.gz,../../DataSet/ASNR-MICCAI-BraTS2023-GLI-Challenge-TrainingData/BraTS-GLI-00432-000/BraTS-GLI-00432-000-seg.nii.gz,107,96,96,65,154,51,143,53,137,89,92,84
00840-000,../../DataSet/ASNR-MICCAI-BraTS2023-GLI-Challenge-TrainingData/BraTS-GLI-00840-000/BraTS-GLI-00840-000-t1c.nii.gz,../../DataSet/ASNR-MICCAI-BraTS2023-GLI-Challenge-TrainingData/BraTS-GLI-00840-000/BraTS-GLI-00840-000-t2w.nii.gz,../../DataSet/ASNR-MICCAI-BraTS2023-GLI-Challenge-TrainingData/BraTS-GLI-00840-000/BraTS-GLI-00840-000-t2f.nii.gz,../../DataSet/ASNR-MICCAI-BraTS2023-GLI-Challenge-TrainingData/BraTS-GLI-00840-000/BraTS-GLI-00840-000-t1n.nii.gz,../../DataSet/ASNR-MICCAI-BraTS2023-GLI-Challenge-TrainingData/BraTS-GLI-00840-000/BraTS-GLI-00840-000-seg.nii.gz,136,106,100,96,174,65,154,54,134,78,89,80
00395-000,../../DataSet/ASNR-MICCAI-BraTS2023-GLI-Challenge-TrainingData/BraTS-GLI-00395-000/BraTS-GLI-00395-000-t1c.nii.gz,../../DataSet/ASNR-MICCAI-BraTS2023-GLI-Challenge-TrainingData/BraTS-GLI-00395-000/BraTS-GLI-00395-000-t2w.nii.gz,../../DataSet/ASNR-MICCAI-BraTS2023-GLI-Challenge-TrainingData/BraTS-GLI-00395-000/BraTS-GLI-00395-000-t2f.nii.gz,../../DataSet/ASNR-MICCAI-BraTS2023-GLI-Challenge-TrainingData/BraTS-GLI-00395-000/BraTS-GLI-00395-000-t1n.nii.gz,../../DataSet/ASNR-MICCAI-BraTS2023-GLI-Challenge-TrainingData/BraTS-GLI-00395-000/BraTS-GLI-00395-000-seg.nii.gz,145,163,71,83,176,113,206,39,107,93,93,68
00676-001,../../DataSet/ASNR-MICCAI-BraTS2023-GLI-Challenge-TrainingData/BraTS-GLI-00676-001/BraTS-GLI-00676-001-t1c.nii.gz,../../DataSet/ASNR-MICCAI-BraTS2023-GLI-Challenge-TrainingData/BraTS-GLI-00676-001/BraTS-GLI-00676-001-t2w.nii.gz,../../DataSet/ASNR-MICCAI-BraTS2023-GLI-Challenge-TrainingData/BraTS-GLI-00676-001/BraTS-GLI-00676-001-t2f.nii.gz,../../DataSet/ASNR-MICCAI-BraTS2023-GLI-Challenge-TrainingData/BraTS-GLI-00676-001/BraTS-GLI-00676-001-t1n.nii.gz,../../DataSet/ASNR-MICCAI-BraTS2023-GLI-Challenge-TrainingData/BraTS-GLI-00676-001/BraTS-GLI-00676-001-seg.nii.gz,135,132,103,98,159,104,162,75,135,61,58,60
00053-000,../../DataSet/ASNR-MICCAI-BraTS2023-GLI-Challenge-TrainingData/BraTS-GLI-00053-000/BraTS-GLI-00053-000-t1c.nii.gz,../../DataSet/ASNR-MICCAI-BraTS2023-GLI-Challenge-TrainingData/BraTS-GLI-00053-000/BraTS-GLI-00053-000-t2w.nii.gz,../../DataSet/ASNR-MICCAI-BraTS2023-GLI-Challenge-TrainingData/BraTS-GLI-00053-000/BraTS-GLI-00053-000-t2f.nii.gz,../../DataSet/ASNR-MICCAI-BraTS2023-GLI-Challenge-TrainingData/BraTS-GLI-00053-000/BraTS-GLI-00053-000-t1n.nii.gz,../../DataSet/ASNR-MICCAI-BraTS2023-GLI-Challenge-TrainingData/BraTS-GLI-00053-000/BraTS-GLI-00053-000-seg.nii.gz,138,95,96,97,171,52,140,58,139,74,88,81
00819-000,../../DataSet/ASNR-MICCAI-BraTS2023-GLI-Challenge-TrainingData/BraTS-GLI-00819-000/BraTS-GLI-00819-000-t1c.nii.gz,../../DataSet/ASNR-MICCAI-BraTS2023-GLI-Challenge-TrainingData/BraTS-GLI-00819-000/BraTS-GLI-00819-000-t2w.nii.gz,../../DataSet/ASNR-MICCAI-BraTS2023-GLI-Challenge-TrainingData/BraTS-GLI-00819-000/BraTS-GLI-00819-000-t2f.nii.gz,../../DataSet/ASNR-MICCAI-BraTS2023-GLI-Challenge-TrainingData/BraTS-GLI-00819-000/BraTS-GLI-00819-000-t1n.nii.gz,../../DataSet/ASNR-MICCAI-BraTS2023-GLI-Challenge-TrainingData/BraTS-GLI-00819-000/BraTS-GLI-00819-000-seg.nii.gz,96,164,85,64,129,119,210,43,132,65,91,89
00777-001,../../DataSet/ASNR-MICCAI-BraTS2023-GLI-Challenge-TrainingData/BraTS-GLI-00777-001/BraTS-GLI-00777-001-t1c.nii.gz,../../DataSet/ASNR-MICCAI-BraTS2023-GLI-Challenge-TrainingData/BraTS-GLI-00777-001/BraTS-GLI-00777-001-t2w.nii.gz,../../DataSet/ASNR-MICCAI-BraTS2023-GLI-Challenge-TrainingData/BraTS-GLI-00777-001/BraTS-GLI-00777-001-t2f.nii.gz,../../DataSet/ASNR-MICCAI-BraTS2023-GLI-Challenge-TrainingData/BraTS-GLI-00777-001/BraTS-GLI-00777-001-t1n.nii.gz,../../DataSet/ASNR-MICCAI-BraTS2023-GLI-Challenge-TrainingData/BraTS-GLI-00777-001/BraTS-GLI-00777-001-seg.nii.gz,84,130,91,55,114,87,173,61,128,59,86,67
00152-000,../../DataSet/ASNR-MICCAI-BraTS2023-GLI-Challenge-TrainingData/BraTS-GLI-00152-000/BraTS-GLI-00152-000-t1c.nii.gz,../../DataSet/ASNR-MICCAI-BraTS2023-GLI-Challenge-TrainingData/BraTS-GLI-00152-000/BraTS-GLI-00152-000-t2w.nii.gz,../../DataSet/ASNR-MICCAI-BraTS2023-GLI-Challenge-TrainingData/BraTS-GLI-00152-000/BraTS-GLI-00152-000-t2f.nii.gz,../../DataSet/ASNR-MICCAI-BraTS2023-GLI-Challenge-TrainingData/BraTS-GLI-00152-000/BraTS-GLI-00152-000-t1n.nii.gz,../../DataSet/ASNR-MICCAI-BraTS2023-GLI-Challenge-TrainingData/BraTS-GLI-00152-000/BraTS-GLI-00152-000-seg.nii.gz,158,110,56,132,184,86,140,33,81,52,54,48
00533-000,../../DataSet/ASNR-MICCAI-BraTS2023-GLI-Challenge-TrainingData/BraTS-GLI-00533-000/BraTS-GLI-00533-000-t1c.nii.gz,../../DataSet/ASNR-MICCAI-BraTS2023-GLI-Challenge-TrainingData/BraTS-GLI-00533-000/BraTS-GLI-00533-000-t2w.nii.gz,../../DataSet/ASNR-MICCAI-BraTS2023-GLI-Challenge-TrainingData/BraTS-GLI-00533-000/BraTS-GLI-00533-000-t2f.nii.gz,../../DataSet/ASNR-MICCAI-BraTS2023-GLI-Challenge-TrainingData/BraTS-GLI-00533-000/BraTS-GLI-00533-000-t1n.nii.gz,../../DataSet/ASNR-MICCAI-BraTS2023-GLI-Challenge-TrainingData/BraTS-GLI-00533-000/BraTS-GLI-00533-000-seg.nii.gz,151,170,76,130,180,135,201,48,114,50,66,66
00294-000,../../DataSet/ASNR-MICCAI-BraTS2023-GLI-Challenge-TrainingData/BraTS-GLI-00294-000/BraTS-GLI-00294-000-t1c.nii.gz,../../DataSet/ASNR-MICCAI-BraTS2023-GLI-Challenge-TrainingData/BraTS-GLI-00294-000/BraTS-GLI-00294-000-t2w.nii.gz,../../DataSet/ASNR-MICCAI-BraTS2023-GLI-Challenge-TrainingData/BraTS-GLI-00294-000/BraTS-GLI-00294-000-t2f.nii.gz,../../DataSet/ASNR-MICCAI-BraTS2023-GLI-Challenge-TrainingData/BraTS-GLI-00294-000/BraTS-GLI-00294-000-t1n.nii.gz,../../DataSet/ASNR-MICCAI-BraTS2023-GLI-Challenge-TrainingData/BraTS-GLI-00294-000/BraTS-GLI-00294-000-seg.nii.gz,97,173,87,69,120,136,212,48,131,51,76,83
01405-000,../../DataSet/ASNR-MICCAI-BraTS2023-GLI-Challenge-TrainingData/BraTS-GLI-01405-000/BraTS-GLI-01405-000-t1c.nii.gz,../../DataSet/ASNR-MICCAI-BraTS2023-GLI-Challenge-TrainingData/BraTS-GLI-01405-000/BraTS-GLI-01405-000-t2w.nii.gz,../../DataSet/ASNR-MICCAI-BraTS2023-GLI-Challenge-TrainingData/BraTS-GLI-01405-000/BraTS-GLI-01405-000-t2f.nii.gz,../../DataSet/ASNR-MICCAI-BraTS2023-GLI-Challenge-TrainingData/BraTS-GLI-01405-000/BraTS-GLI-01405-000-t1n.nii.gz,../../DataSet/ASNR-MICCAI-BraTS2023-GLI-Challenge-TrainingData/BraTS-GLI-01405-000/BraTS-GLI-01405-000-seg.nii.gz,127,155,106,117,140,126,193,82,123,23,67,41
00183-000,../../DataSet/ASNR-MICCAI-BraTS2023-GLI-Challenge-TrainingData/BraTS-GLI-00183-000/BraTS-GLI-00183-000-t1c.nii.gz,../../DataSet/ASNR-MICCAI-BraTS2023-GLI-Challenge-TrainingData/BraTS-GLI-00183-000/BraTS-GLI-00183-000-t2w.nii.gz,../../DataSet/ASNR-MICCAI-BraTS2023-GLI-Challenge-TrainingData/BraTS-GLI-00183-000/BraTS-GLI-00183-000-t2f.nii.gz,../../DataSet/ASNR-MICCAI-BraTS2023-GLI-Challenge-TrainingData/BraTS-GLI-00183-000/BraTS-GLI-00183-000-t1n.nii.gz,../../DataSet/ASNR-MICCAI-BraTS2023-GLI-Challenge-TrainingData/BraTS-GLI-00183-000/BraTS-GLI-00183-000-seg.nii.gz,139,93,88,100,174,49,135,51,130,74,86,79
00624-000,../../DataSet/ASNR-MICCAI-BraTS2023-GLI-Challenge-TrainingData/BraTS-GLI-00624-000/BraTS-GLI-00624-000-t1c.nii.gz,../../DataSet/ASNR-MICCAI-BraTS2023-GLI-Challenge-TrainingData/BraTS-GLI-00624-000/BraTS-GLI-00624-000-t2w.nii.gz,../../DataSet/ASNR-MICCAI-BraTS2023-GLI-Challenge-TrainingData/BraTS-GLI-00624-000/BraTS-GLI-00624-000-t2f.nii.gz,../../DataSet/ASNR-MICCAI-BraTS2023-GLI-Challenge-TrainingData/BraTS-GLI-00624-000/BraTS-GLI-00624-000-t1n.nii.gz,../../DataSet/ASNR-MICCAI-BraTS2023-GLI-Challenge-TrainingData/BraTS-GLI-00624-000/BraTS-GLI-00624-000-seg.nii.gz,159,140,90,134,188,102,175,66,122,54,73,56
00544-001,../../DataSet/ASNR-MICCAI-BraTS2023-GLI-Challenge-TrainingData/BraTS-GLI-00544-001/BraTS-GLI-00544-001-t1c.nii.gz,../../DataSet/ASNR-MICCAI-BraTS2023-GLI-Challenge-TrainingData/BraTS-GLI-00544-001/BraTS-GLI-00544-001-t2w.nii.gz,../../DataSet/ASNR-MICCAI-BraTS2023-GLI-Challenge-TrainingData/BraTS-GLI-00544-001/BraTS-GLI-00544-001-t2f.nii.gz,../../DataSet/ASNR-MICCAI-BraTS2023-GLI-Challenge-TrainingData/BraTS-GLI-00544-001/BraTS-GLI-00544-001-t1n.nii.gz,../../DataSet/ASNR-MICCAI-BraTS2023-GLI-Challenge-TrainingData/BraTS-GLI-00544-001/BraTS-GLI-00544-001-seg.nii.gz,154,110,46,128,178,84,143,20,75,50,59,55
01140-000,../../DataSet/ASNR-MICCAI-BraTS2023-GLI-Challenge-TrainingData/BraTS-GLI-01140-000/BraTS-GLI-01140-000-t1c.nii.gz,../../DataSet/ASNR-MICCAI-BraTS2023-GLI-Challenge-TrainingData/BraTS-GLI-01140-000/BraTS-GLI-01140-000-t2w.nii.gz,../../DataSet/ASNR-MICCAI-BraTS2023-GLI-Challenge-TrainingData/BraTS-GLI-01140-000/BraTS-GLI-01140-000-t2f.nii.gz,../../DataSet/ASNR-MICCAI-BraTS2023-GLI-Challenge-TrainingData/BraTS-GLI-01140-000/BraTS-GLI-01140-000-t1n.nii.gz,../../DataSet/ASNR-MICCAI-BraTS2023-GLI-Challenge-TrainingData/BraTS-GLI-01140-000/BraTS-GLI-01140-000-seg.nii.gz,136,166,91,113,164,125,202,61,125,51,77,64
00682-001,../../DataSet/ASNR-MICCAI-BraTS2023-GLI-Challenge-TrainingData/BraTS-GLI-00682-001/BraTS-GLI-00682-001-t1c.nii.gz,../../DataSet/ASNR-MICCAI-BraTS2023-GLI-Challenge-TrainingData/BraTS-GLI-00682-001/BraTS-GLI-00682-001-t2w.nii.gz,../../DataSet/ASNR-MICCAI-BraTS2023-GLI-Challenge-TrainingData/BraTS-GLI-00682-001/BraTS-GLI-00682-001-t2f.nii.gz,../../DataSet/ASNR-MICCAI-BraTS2023-GLI-Challenge-TrainingData/BraTS-GLI-00682-001/BraTS-GLI-00682-001-t1n.nii.gz,../../DataSet/ASNR-MICCAI-BraTS2023-GLI-Challenge-TrainingData/BraTS-GLI-00682-001/BraTS-GLI-00682-001-seg.nii.gz,154,146,89,130,182,107,179,57,129,52,72,72
01191-000,../../DataSet/ASNR-MICCAI-BraTS2023-GLI-Challenge-TrainingData/BraTS-GLI-01191-000/BraTS-GLI-01191-000-t1c.nii.gz,../../DataSet/ASNR-MICCAI-BraTS2023-GLI-Challenge-TrainingData/BraTS-GLI-01191-000/BraTS-GLI-01191-000-t2w.nii.gz,../../DataSet/ASNR-MICCAI-BraTS2023-GLI-Challenge-TrainingData/BraTS-GLI-01191-000/BraTS-GLI-01191-000-t2f.nii.gz,../../DataSet/ASNR-MICCAI-BraTS2023-GLI-Challenge-TrainingData/BraTS-GLI-01191-000/BraTS-GLI-01191-000-t1n.nii.gz,../../DataSet/ASNR-MICCAI-BraTS2023-GLI-Challenge-TrainingData/BraTS-GLI-01191-000/BraTS-GLI-01191-000-seg.nii.gz,81,144,92,54,116,106,180,62,124,62,74,62
01257-000,../../DataSet/ASNR-MICCAI-BraTS2023-GLI-Challenge-TrainingData/BraTS-GLI-01257-000/BraTS-GLI-01257-000-t1c.nii.gz,../../DataSet/ASNR-MICCAI-BraTS2023-GLI-Challenge-TrainingData/BraTS-GLI-01257-000/BraTS-GLI-01257-000-t2w.nii.gz,../../DataSet/ASNR-MICCAI-BraTS2023-GLI-Challenge-TrainingData/BraTS-GLI-01257-000/BraTS-GLI-01257-000-t2f.nii.gz,../../DataSet/ASNR-MICCAI-BraTS2023-GLI-Challenge-TrainingData/BraTS-GLI-01257-000/BraTS-GLI-01257-000-t1n.nii.gz,../../DataSet/ASNR-MICCAI-BraTS2023-GLI-Challenge-TrainingData/BraTS-GLI-01257-000/BraTS-GLI-01257-000-seg.nii.gz,161,126,68,121,186,100,158,49,88,65,58,39
00689-000,../../DataSet/ASNR-MICCAI-BraTS2023-GLI-Challenge-TrainingData/BraTS-GLI-00689-000/BraTS-GLI-00689-000-t1c.nii.gz,../../DataSet/ASNR-MICCAI-BraTS2023-GLI-Challenge-TrainingData/BraTS-GLI-00689-000/BraTS-GLI-00689-000-t2w.nii.gz,../../DataSet/ASNR-MICCAI-BraTS2023-GLI-Challenge-TrainingData/BraTS-GLI-00689-000/BraTS-GLI-00689-000-t2f.nii.gz,../../DataSet/ASNR-MICCAI-BraTS2023-GLI-Challenge-TrainingData/BraTS-GLI-00689-000/BraTS-GLI-00689-000-t1n.nii.gz,../../DataSet/ASNR-MICCAI-BraTS2023-GLI-Challenge-TrainingData/BraTS-GLI-00689-000/BraTS-GLI-00689-000-seg.nii.gz,159,129,69,124,188,85,176,38,103,64,91,65
01479-000,../../DataSet/ASNR-MICCAI-BraTS2023-GLI-Challenge-TrainingData/BraTS-GLI-01479-000/BraTS-GLI-01479-000-t1c.nii.gz,../../DataSet/ASNR-MICCAI-BraTS2023-GLI-Challenge-TrainingData/BraTS-GLI-01479-000/BraTS-GLI-01479-000-t2w.nii.gz,../../DataSet/ASNR-MICCAI-BraTS2023-GLI-Challenge-TrainingData/BraTS-GLI-01479-000/BraTS-GLI-01479-000-t2f.nii.gz,../../DataSet/ASNR-MICCAI-BraTS2023-GLI-Challenge-TrainingData/BraTS-GLI-01479-000/BraTS-GLI-01479-000-t1n.nii.gz,../../DataSet/ASNR-MICCAI-BraTS2023-GLI-Challenge-TrainingData/BraTS-GLI-01479-000/BraTS-GLI-01479-000-seg.nii.gz,105,95,95,61,151,55,139,58,138,90,84,80
01018-000,../../DataSet/ASNR-MICCAI-BraTS2023-GLI-Challenge-TrainingData/BraTS-GLI-01018-000/BraTS-GLI-01018-000-t1c.nii.gz,../../DataSet/ASNR-MICCAI-BraTS2023-GLI-Challenge-TrainingData/BraTS-GLI-01018-000/BraTS-GLI-01018-000-t2w.nii.gz,../../DataSet/ASNR-MICCAI-BraTS2023-GLI-Challenge-TrainingData/BraTS-GLI-01018-000/BraTS-GLI-01018-000-t2f.nii.gz,../../DataSet/ASNR-MICCAI-BraTS2023-GLI-Challenge-TrainingData/BraTS-GLI-01018-000/BraTS-GLI-01018-000-t1n.nii.gz,../../DataSet/ASNR-MICCAI-BraTS2023-GLI-Challenge-TrainingData/BraTS-GLI-01018-000/BraTS-GLI-01018-000-seg.nii.gz,81,135,72,54,114,88,178,36,117,60,90,81
00658-000,../../DataSet/ASNR-MICCAI-BraTS2023-GLI-Challenge-TrainingData/BraTS-GLI-00658-000/BraTS-GLI-00658-000-t1c.nii.gz,../../DataSet/ASNR-MICCAI-BraTS2023-GLI-Challenge-TrainingData/BraTS-GLI-00658-000/BraTS-GLI-00658-000-t2w.nii.gz,../../DataSet/ASNR-MICCAI-BraTS2023-GLI-Challenge-TrainingData/BraTS-GLI-00658-000/BraTS-GLI-00658-000-t2f.nii.gz,../../DataSet/ASNR-MICCAI-BraTS2023-GLI-Challenge-TrainingData/BraTS-GLI-00658-000/BraTS-GLI-00658-000-t1n.nii.gz,../../DataSet/ASNR-MICCAI-BraTS2023-GLI-Challenge-TrainingData/BraTS-GLI-00658-000/BraTS-GLI-00658-000-seg.nii.gz,160,104,51,133,185,75,143,22,82,52,68,60
01281-000,../../DataSet/ASNR-MICCAI-BraTS2023-GLI-Challenge-TrainingData/BraTS-GLI-01281-000/BraTS-GLI-01281-000-t1c.nii.gz,../../DataSet/ASNR-MICCAI-BraTS2023-GLI-Challenge-TrainingData/BraTS-GLI-01281-000/BraTS-GLI-01281-000-t2w.nii.gz,../../DataSet/ASNR-MICCAI-BraTS2023-GLI-Challenge-TrainingData/BraTS-GLI-01281-000/BraTS-GLI-01281-000-t2f.nii.gz,../../DataSet/ASNR-MICCAI-BraTS2023-GLI-Challenge-TrainingData/BraTS-GLI-01281-000/BraTS-GLI-01281-000-t1n.nii.gz,../../DataSet/ASNR-MICCAI-BraTS2023-GLI-Challenge-TrainingData/BraTS-GLI-01281-000/BraTS-GLI-01281-000-seg.nii.gz,145,105,94,108,179,59,146,59,132,71,87,73
00366-000,../../DataSet/ASNR-MICCAI-BraTS2023-GLI-Challenge-TrainingData/BraTS-GLI-00366-000/BraTS-GLI-00366-000-t1c.nii.gz,../../DataSet/ASNR-MICCAI-BraTS2023-GLI-Challenge-TrainingData/BraTS-GLI-00366-000/BraTS-GLI-00366-000-t2w.nii.gz,../../DataSet/ASNR-MICCAI-BraTS2023-GLI-Challenge-TrainingData/BraTS-GLI-00366-000/BraTS-GLI-00366-000-t2f.nii.gz,../../DataSet/ASNR-MICCAI-BraTS2023-GLI-Challenge-TrainingData/BraTS-GLI-00366-000/BraTS-GLI-00366-000-t1n.nii.gz,../../DataSet/ASNR-MICCAI-BraTS2023-GLI-Challenge-TrainingData/BraTS-GLI-00366-000/BraTS-GLI-00366-000-seg.nii.gz,84,138,81,55,117,104,174,55,109,62,70,54
00707-000,../../DataSet/ASNR-MICCAI-BraTS2023-GLI-Challenge-TrainingData/BraTS-GLI-00707-000/BraTS-GLI-00707-000-t1c.nii.gz,../../DataSet/ASNR-MICCAI-BraTS2023-GLI-Challenge-TrainingData/BraTS-GLI-00707-000/BraTS-GLI-00707-000-t2w.nii.gz,../../DataSet/ASNR-MICCAI-BraTS2023-GLI-Challenge-TrainingData/BraTS-GLI-00707-000/BraTS-GLI-00707-000-t2f.nii.gz,../../DataSet/ASNR-MICCAI-BraTS2023-GLI-Challenge-TrainingData/BraTS-GLI-00707-000/BraTS-GLI-00707-000-t1n.nii.gz,../../DataSet/ASNR-MICCAI-BraTS2023-GLI-Challenge-TrainingData/BraTS-GLI-00707-000/BraTS-GLI-00707-000-seg.nii.gz,91,172,78,64,119,135,210,41,121,55,75,80
01196-000,../../DataSet/ASNR-MICCAI-BraTS2023-GLI-Challenge-TrainingData/BraTS-GLI-01196-000/BraTS-GLI-01196-000-t1c.nii.gz,../../DataSet/ASNR-MICCAI-BraTS2023-GLI-Challenge-TrainingData/BraTS-GLI-01196-000/BraTS-GLI-01196-000-t2w.nii.gz,../../DataSet/ASNR-MICCAI-BraTS2023-GLI-Challenge-TrainingData/BraTS-GLI-01196-000/BraTS-GLI-01196-000-t2f.nii.gz,../../DataSet/ASNR-MICCAI-BraTS2023-GLI-Challenge-TrainingData/BraTS-GLI-01196-000/BraTS-GLI-01196-000-t1n.nii.gz,../../DataSet/ASNR-MICCAI-BraTS2023-GLI-Challenge-TrainingData/BraTS-GLI-01196-000/BraTS-GLI-01196-000-seg.nii.gz,146,107,105,123,172,60,153,76,131,49,93,55
00654-001,../../DataSet/ASNR-MICCAI-BraTS2023-GLI-Challenge-TrainingData/BraTS-GLI-00654-001/BraTS-GLI-00654-001-t1c.nii.gz,../../DataSet/ASNR-MICCAI-BraTS2023-GLI-Challenge-TrainingData/BraTS-GLI-00654-001/BraTS-GLI-00654-001-t2w.nii.gz,../../DataSet/ASNR-MICCAI-BraTS2023-GLI-Challenge-TrainingData/BraTS-GLI-00654-001/BraTS-GLI-00654-001-t2f.nii.gz,../../DataSet/ASNR-MICCAI-BraTS2023-GLI-Challenge-TrainingData/BraTS-GLI-00654-001/BraTS-GLI-00654-001-t1n.nii.gz,../../DataSet/ASNR-MICCAI-BraTS2023-GLI-Challenge-TrainingData/BraTS-GLI-00654-001/BraTS-GLI-00654-001-seg.nii.gz,93,109,90,62,140,74,144,37,129,78,70,92
00071-000,../../DataSet/ASNR-MICCAI-BraTS2023-GLI-Challenge-TrainingData/BraTS-GLI-00071-000/BraTS-GLI-00071-000-t1c.nii.gz,../../DataSet/ASNR-MICCAI-BraTS2023-GLI-Challenge-TrainingData/BraTS-GLI-00071-000/BraTS-GLI-00071-000-t2w.nii.gz,../../DataSet/ASNR-MICCAI-BraTS2023-GLI-Challenge-TrainingData/BraTS-GLI-00071-000/BraTS-GLI-00071-000-t2f.nii.gz,../../DataSet/ASNR-MICCAI-BraTS2023-GLI-Challenge-TrainingData/BraTS-GLI-00071-000/BraTS-GLI-00071-000-t1n.nii.gz,../../DataSet/ASNR-MICCAI-BraTS2023-GLI-Challenge-TrainingData/BraTS-GLI-00071-000/BraTS-GLI-00071-000-seg.nii.gz,90,175,69,62,117,129,208,41,109,55,79,68
01250-000,../../DataSet/ASNR-MICCAI-BraTS2023-GLI-Challenge-TrainingData/BraTS-GLI-01250-000/BraTS-GLI-01250-000-t1c.nii.gz,../../DataSet/ASNR-MICCAI-BraTS2023-GLI-Challenge-TrainingData/BraTS-GLI-01250-000/BraTS-GLI-01250-000-t2w.nii.gz,../../DataSet/ASNR-MICCAI-BraTS2023-GLI-Challenge-TrainingData/BraTS-GLI-01250-000/BraTS-GLI-01250-000-t2f.nii.gz,../../DataSet/ASNR-MICCAI-BraTS2023-GLI-Challenge-TrainingData/BraTS-GLI-01250-000/BraTS-GLI-01250-000-t1n.nii.gz,../../DataSet/ASNR-MICCAI-BraTS2023-GLI-Challenge-TrainingData/BraTS-GLI-01250-000/BraTS-GLI-01250-000-seg.nii.gz,96,143,82,66,123,112,182,51,111,57,70,60
01308-000,../../DataSet/ASNR-MICCAI-BraTS2023-GLI-Challenge-TrainingData/BraTS-GLI-01308-000/BraTS-GLI-01308-000-t1c.nii.gz,../../DataSet/ASNR-MICCAI-BraTS2023-GLI-Challenge-TrainingData/BraTS-GLI-01308-000/BraTS-GLI-01308-000-t2w.nii.gz,../../DataSet/ASNR-MICCAI-BraTS2023-GLI-Challenge-TrainingData/BraTS-GLI-01308-000/BraTS-GLI-01308-000-t2f.nii.gz,../../DataSet/ASNR-MICCAI-BraTS2023-GLI-Challenge-TrainingData/BraTS-GLI-01308-000/BraTS-GLI-01308-000-t1n.nii.gz,../../DataSet/ASNR-MICCAI-BraTS2023-GLI-Challenge-TrainingData/BraTS-GLI-01308-000/BraTS-GLI-01308-000-seg.nii.gz,175,150,87,166,185,136,164,76,98,19,28,22
00599-000,../../DataSet/ASNR-MICCAI-BraTS2023-GLI-Challenge-TrainingData/BraTS-GLI-00599-000/BraTS-GLI-00599-000-t1c.nii.gz,../../DataSet/ASNR-MICCAI-BraTS2023-GLI-Challenge-TrainingData/BraTS-GLI-00599-000/BraTS-GLI-00599-000-t2w.nii.gz,../../DataSet/ASNR-MICCAI-BraTS2023-GLI-Challenge-TrainingData/BraTS-GLI-00599-000/BraTS-GLI-00599-000-t2f.nii.gz,../../DataSet/ASNR-MICCAI-BraTS2023-GLI-Challenge-TrainingData/BraTS-GLI-00599-000/BraTS-GLI-00599-000-t1n.nii.gz,../../DataSet/ASNR-MICCAI-BraTS2023-GLI-Challenge-TrainingData/BraTS-GLI-00599-000/BraTS-GLI-00599-000-seg.nii.gz,101,109,102,71,128,65,155,73,137,57,90,64
00155-000,../../DataSet/ASNR-MICCAI-BraTS2023-GLI-Challenge-TrainingData/BraTS-GLI-00155-000/BraTS-GLI-00155-000-t1c.nii.gz,../../DataSet/ASNR-MICCAI-BraTS2023-GLI-Challenge-TrainingData/BraTS-GLI-00155-000/BraTS-GLI-00155-000-t2w.nii.gz,../../DataSet/ASNR-MICCAI-BraTS2023-GLI-Challenge-TrainingData/BraTS-GLI-00155-000/BraTS-GLI-00155-000-t2f.nii.gz,../../DataSet/ASNR-MICCAI-BraTS2023-GLI-Challenge-TrainingData/BraTS-GLI-00155-000/BraTS-GLI-00155-000-t1n.nii.gz,../../DataSet/ASNR-MICCAI-BraTS2023-GLI-Challenge-TrainingData/BraTS-GLI-00155-000/BraTS-GLI-00155-000-seg.nii.gz,105,124,56,82,129,100,150,34,80,47,50,46
00293-000,../../DataSet/ASNR-MICCAI-BraTS2023-GLI-Challenge-TrainingData/BraTS-GLI-00293-000/BraTS-GLI-00293-000-t1c.nii.gz,../../DataSet/ASNR-MICCAI-BraTS2023-GLI-Challenge-TrainingData/BraTS-GLI-00293-000/BraTS-GLI-00293-000-t2w.nii.gz,../../DataSet/ASNR-MICCAI-BraTS2023-GLI-Challenge-TrainingData/BraTS-GLI-00293-000/BraTS-GLI-00293-000-t2f.nii.gz,../../DataSet/ASNR-MICCAI-BraTS2023-GLI-Challenge-TrainingData/BraTS-GLI-00293-000/BraTS-GLI-00293-000-t1n.nii.gz,../../DataSet/ASNR-MICCAI-BraTS2023-GLI-Challenge-TrainingData/BraTS-GLI-00293-000/BraTS-GLI-00293-000-seg.nii.gz,159,86,83,140,178,54,118,59,107,38,64,48
01374-000,../../DataSet/ASNR-MICCAI-BraTS2023-GLI-Challenge-TrainingData/BraTS-GLI-01374-000/BraTS-GLI-01374-000-t1c.nii.gz,../../DataSet/ASNR-MICCAI-BraTS2023-GLI-Challenge-TrainingData/BraTS-GLI-01374-000/BraTS-GLI-01374-000-t2w.nii.gz,../../DataSet/ASNR-MICCAI-BraTS2023-GLI-Challenge-TrainingData/BraTS-GLI-01374-000/BraTS-GLI-01374-000-t2f.nii.gz,../../DataSet/ASNR-MICCAI-BraTS2023-GLI-Challenge-TrainingData/BraTS-GLI-01374-000/BraTS-GLI-01374-000-t1n.nii.gz,../../DataSet/ASNR-MICCAI-BraTS2023-GLI-Challenge-TrainingData/BraTS-GLI-01374-000/BraTS-GLI-01374-000-seg.nii.gz,148,160,88,120,178,119,206,54,125,58,87,71
00184-000,../../DataSet/ASNR-MICCAI-BraTS2023-GLI-Challenge-TrainingData/BraTS-GLI-00184-000/BraTS-GLI-00184-000-t1c.nii.gz,../../DataSet/ASNR-MICCAI-BraTS2023-GLI-Challenge-TrainingData/BraTS-GLI-00184-000/BraTS-GLI-00184-000-t2w.nii.gz,../../DataSet/ASNR-MICCAI-BraTS2023-GLI-Challenge-TrainingData/BraTS-GLI-00184-000/BraTS-GLI-00184-000-t2f.nii.gz,../../DataSet/ASNR-MICCAI-BraTS2023-GLI-Challenge-TrainingData/BraTS-GLI-00184-000/BraTS-GLI-00184-000-t1n.nii.gz,../../DataSet/ASNR-MICCAI-BraTS2023-GLI-Challenge-TrainingData/BraTS-GLI-00184-000/BraTS-GLI-00184-000-seg.nii.gz,147,136,71,101,181,104,170,42,100,80,66,58
01149-000,../../DataSet/ASNR-MICCAI-BraTS2023-GLI-Challenge-TrainingData/BraTS-GLI-01149-000/BraTS-GLI-01149-000-t1c.nii.gz,../../DataSet/ASNR-MICCAI-BraTS2023-GLI-Challenge-TrainingData/BraTS-GLI-01149-000/BraTS-GLI-01149-000-t2w.nii.gz,../../DataSet/ASNR-MICCAI-BraTS2023-GLI-Challenge-TrainingData/BraTS-GLI-01149-000/BraTS-GLI-01149-000-t2f.nii.gz,../../DataSet/ASNR-MICCAI-BraTS2023-GLI-Challenge-TrainingData/BraTS-GLI-01149-000/BraTS-GLI-01149-000-t1n.nii.gz,../../DataSet/ASNR-MICCAI-BraTS2023-GLI-Challenge-TrainingData/BraTS-GLI-01149-000/BraTS-GLI-01149-000-seg.nii.gz,89,109,51,72,139,91,187,31,75,67,96,44
00709-000,../../DataSet/ASNR-MICCAI-BraTS2023-GLI-Challenge-TrainingData/BraTS-GLI-00709-000/BraTS-GLI-00709-000-t1c.nii.gz,../../DataSet/ASNR-MICCAI-BraTS2023-GLI-Challenge-TrainingData/BraTS-GLI-00709-000/BraTS-GLI-00709-000-t2w.nii.gz,../../DataSet/ASNR-MICCAI-BraTS2023-GLI-Challenge-TrainingData/BraTS-GLI-00709-000/BraTS-GLI-00709-000-t2f.nii.gz,../../DataSet/ASNR-MICCAI-BraTS2023-GLI-Challenge-TrainingData/BraTS-GLI-00709-000/BraTS-GLI-00709-000-t1n.nii.gz,../../DataSet/ASNR-MICCAI-BraTS2023-GLI-Challenge-TrainingData/BraTS-GLI-00709-000/BraTS-GLI-00709-000-seg.nii.gz,150,163,74,124,178,114,198,41,113,54,84,72
00127-000,../../DataSet/ASNR-MICCAI-BraTS2023-GLI-Challenge-TrainingData/BraTS-GLI-00127-000/BraTS-GLI-00127-000-t1c.nii.gz,../../DataSet/ASNR-MICCAI-BraTS2023-GLI-Challenge-TrainingData/BraTS-GLI-00127-000/BraTS-GLI-00127-000-t2w.nii.gz,../../DataSet/ASNR-MICCAI-BraTS2023-GLI-Challenge-TrainingData/BraTS-GLI-00127-000/BraTS-GLI-00127-000-t2f.nii.gz,../../DataSet/ASNR-MICCAI-BraTS2023-GLI-Challenge-TrainingData/BraTS-GLI-00127-000/BraTS-GLI-00127-000-t1n.nii.gz,../../DataSet/ASNR-MICCAI-BraTS2023-GLI-Challenge-TrainingData/BraTS-GLI-00127-000/BraTS-GLI-00127-000-seg.nii.gz,164,129,61,137,191,84,174,33,92,54,90,59
00680-000,../../DataSet/ASNR-MICCAI-BraTS2023-GLI-Challenge-TrainingData/BraTS-GLI-00680-000/BraTS-GLI-00680-000-t1c.nii.gz,../../DataSet/ASNR-MICCAI-BraTS2023-GLI-Challenge-TrainingData/BraTS-GLI-00680-000/BraTS-GLI-00680-000-t2w.nii.gz,../../DataSet/ASNR-MICCAI-BraTS2023-GLI-Challenge-TrainingData/BraTS-GLI-00680-000/BraTS-GLI-00680-000-t2f.nii.gz,../../DataSet/ASNR-MICCAI-BraTS2023-GLI-Challenge-TrainingData/BraTS-GLI-00680-000/BraTS-GLI-00680-000-t1n.nii.gz,../../DataSet/ASNR-MICCAI-BraTS2023-GLI-Challenge-TrainingData/BraTS-GLI-00680-000/BraTS-GLI-00680-000-seg.nii.gz,147,96,82,126,173,58,143,52,113,47,85,61
01306-000,../../DataSet/ASNR-MICCAI-BraTS2023-GLI-Challenge-TrainingData/BraTS-GLI-01306-000/BraTS-GLI-01306-000-t1c.nii.gz,../../DataSet/ASNR-MICCAI-BraTS2023-GLI-Challenge-TrainingData/BraTS-GLI-01306-000/BraTS-GLI-01306-000-t2w.nii.gz,../../DataSet/ASNR-MICCAI-BraTS2023-GLI-Challenge-TrainingData/BraTS-GLI-01306-000/BraTS-GLI-01306-000-t2f.nii.gz,../../DataSet/ASNR-MICCAI-BraTS2023-GLI-Challenge-TrainingData/BraTS-GLI-01306-000/BraTS-GLI-01306-000-t1n.nii.gz,../../DataSet/ASNR-MICCAI-BraTS2023-GLI-Challenge-TrainingData/BraTS-GLI-01306-000/BraTS-GLI-01306-000-seg.nii.gz,103,82,80,78,129,56,115,56,107,51,59,51
00597-000,../../DataSet/ASNR-MICCAI-BraTS2023-GLI-Challenge-TrainingData/BraTS-GLI-00597-000/BraTS-GLI-00597-000-t1c.nii.gz,../../DataSet/ASNR-MICCAI-BraTS2023-GLI-Challenge-TrainingData/BraTS-GLI-00597-000/BraTS-GLI-00597-000-t2w.nii.gz,../../DataSet/ASNR-MICCAI-BraTS2023-GLI-Challenge-TrainingData/BraTS-GLI-00597-000/BraTS-GLI-00597-000-t2f.nii.gz,../../DataSet/ASNR-MICCAI-BraTS2023-GLI-Challenge-TrainingData/BraTS-GLI-00597-000/BraTS-GLI-00597-000-t1n.nii.gz,../../DataSet/ASNR-MICCAI-BraTS2023-GLI-Challenge-TrainingData/BraTS-GLI-00597-000/BraTS-GLI-00597-000-seg.nii.gz,137,174,99,117,169,144,208,72,134,52,64,62
00230-000,../../DataSet/ASNR-MICCAI-BraTS2023-GLI-Challenge-TrainingData/BraTS-GLI-00230-000/BraTS-GLI-00230-000-t1c.nii.gz,../../DataSet/ASNR-MICCAI-BraTS2023-GLI-Challenge-TrainingData/BraTS-GLI-00230-000/BraTS-GLI-00230-000-t2w.nii.gz,../../DataSet/ASNR-MICCAI-BraTS2023-GLI-Challenge-TrainingData/BraTS-GLI-00230-000/BraTS-GLI-00230-000-t2f.nii.gz,../../DataSet/ASNR-MICCAI-BraTS2023-GLI-Challenge-TrainingData/BraTS-GLI-00230-000/BraTS-GLI-00230-000-t1n.nii.gz,../../DataSet/ASNR-MICCAI-BraTS2023-GLI-Challenge-TrainingData/BraTS-GLI-00230-000/BraTS-GLI-00230-000-seg.nii.gz,139,166,93,117,167,133,202,64,131,50,69,67
01470-000,../../DataSet/ASNR-MICCAI-BraTS2023-GLI-Challenge-TrainingData/BraTS-GLI-01470-000/BraTS-GLI-01470-000-t1c.nii.gz,../../DataSet/ASNR-MICCAI-BraTS2023-GLI-Challenge-TrainingData/BraTS-GLI-01470-000/BraTS-GLI-01470-000-t2w.nii.gz,../../DataSet/ASNR-MICCAI-BraTS2023-GLI-Challenge-TrainingData/BraTS-GLI-01470-000/BraTS-GLI-01470-000-t2f.nii.gz,../../DataSet/ASNR-MICCAI-BraTS2023-GLI-Challenge-TrainingData/BraTS-GLI-01470-000/BraTS-GLI-01470-000-t1n.nii.gz,../../DataSet/ASNR-MICCAI-BraTS2023-GLI-Challenge-TrainingData/BraTS-GLI-01470-000/BraTS-GLI-01470-000-seg.nii.gz,77,122,61,57,109,85,169,31,91,52,84,60
01011-000,../../DataSet/ASNR-MICCAI-BraTS2023-GLI-Challenge-TrainingData/BraTS-GLI-01011-000/BraTS-GLI-01011-000-t1c.nii.gz,../../DataSet/ASNR-MICCAI-BraTS2023-GLI-Challenge-TrainingData/BraTS-GLI-01011-000/BraTS-GLI-01011-000-t2w.nii.gz,../../DataSet/ASNR-MICCAI-BraTS2023-GLI-Challenge-TrainingData/BraTS-GLI-01011-000/BraTS-GLI-01011-000-t2f.nii.gz,../../DataSet/ASNR-MICCAI-BraTS2023-GLI-Challenge-TrainingData/BraTS-GLI-01011-000/BraTS-GLI-01011-000-t1n.nii.gz,../../DataSet/ASNR-MICCAI-BraTS2023-GLI-Challenge-TrainingData/BraTS-GLI-01011-000/BraTS-GLI-01011-000-seg.nii.gz,154,130,93,131,181,95,170,64,126,50,75,62
00314-000,../../DataSet/ASNR-MICCAI-BraTS2023-GLI-Challenge-TrainingData/BraTS-GLI-00314-000/BraTS-GLI-00314-000-t1c.nii.gz,../../DataSet/ASNR-MICCAI-BraTS2023-GLI-Challenge-TrainingData/BraTS-GLI-00314-000/BraTS-GLI-00314-000-t2w.nii.gz,../../DataSet/ASNR-MICCAI-BraTS2023-GLI-Challenge-TrainingData/BraTS-GLI-00314-000/BraTS-GLI-00314-000-t2f.nii.gz,../../DataSet/ASNR-MICCAI-BraTS2023-GLI-Challenge-TrainingData/BraTS-GLI-00314-000/BraTS-GLI-00314-000-t1n.nii.gz,../../DataSet/ASNR-MICCAI-BraTS2023-GLI-Challenge-TrainingData/BraTS-GLI-00314-000/BraTS-GLI-00314-000-seg.nii.gz,83,136,83,57,104,106,163,64,103,47,57,39
01135-000,../../DataSet/ASNR-MICCAI-BraTS2023-GLI-Challenge-TrainingData/BraTS-GLI-01135-000/BraTS-GLI-01135-000-t1c.nii.gz,../../DataSet/ASNR-MICCAI-BraTS2023-GLI-Challenge-TrainingData/BraTS-GLI-01135-000/BraTS-GLI-01135-000-t2w.nii.gz,../../DataSet/ASNR-MICCAI-BraTS2023-GLI-Challenge-TrainingData/BraTS-GLI-01135-000/BraTS-GLI-01135-000-t2f.nii.gz,../../DataSet/ASNR-MICCAI-BraTS2023-GLI-Challenge-TrainingData/BraTS-GLI-01135-000/BraTS-GLI-01135-000-t1n.nii.gz,../../DataSet/ASNR-MICCAI-BraTS2023-GLI-Challenge-TrainingData/BraTS-GLI-01135-000/BraTS-GLI-01135-000-seg.nii.gz,101,106,98,65,145,65,148,66,139,80,83,73
00775-000,../../DataSet/ASNR-MICCAI-BraTS2023-GLI-Challenge-TrainingData/BraTS-GLI-00775-000/BraTS-GLI-00775-000-t1c.nii.gz,../../DataSet/ASNR-MICCAI-BraTS2023-GLI-Challenge-TrainingData/BraTS-GLI-00775-000/BraTS-GLI-00775-000-t2w.nii.gz,../../DataSet/ASNR-MICCAI-BraTS2023-GLI-Challenge-TrainingData/BraTS-GLI-00775-000/BraTS-GLI-00775-000-t2f.nii.gz,../../DataSet/ASNR-MICCAI-BraTS2023-GLI-Challenge-TrainingData/BraTS-GLI-00775-000/BraTS-GLI-00775-000-t1n.nii.gz,../../DataSet/ASNR-MICCAI-BraTS2023-GLI-Challenge-TrainingData/BraTS-GLI-00775-000/BraTS-GLI-00775-000-seg.nii.gz,87,116,44,68,110,83,157,22,72,42,74,50
00003-000,../../DataSet/ASNR-MICCAI-BraTS2023-GLI-Challenge-TrainingData/BraTS-GLI-00003-000/BraTS-GLI-00003-000-t1c.nii.gz,../../DataSet/ASNR-MICCAI-BraTS2023-GLI-Challenge-TrainingData/BraTS-GLI-00003-000/BraTS-GLI-00003-000-t2w.nii.gz,../../DataSet/ASNR-MICCAI-BraTS2023-GLI-Challenge-TrainingData/BraTS-GLI-00003-000/BraTS-GLI-00003-000-t2f.nii.gz,../../DataSet/ASNR-MICCAI-BraTS2023-GLI-Challenge-TrainingData/BraTS-GLI-00003-000/BraTS-GLI-00003-000-t1n.nii.gz,../../DataSet/ASNR-MICCAI-BraTS2023-GLI-Challenge-TrainingData/BraTS-GLI-00003-000/BraTS-GLI-00003-000-seg.nii.gz,133,117,108,109,161,84,155,78,137,52,71,59
01222-000,../../DataSet/ASNR-MICCAI-BraTS2023-GLI-Challenge-TrainingData/BraTS-GLI-01222-000/BraTS-GLI-01222-000-t1c.nii.gz,../../DataSet/ASNR-MICCAI-BraTS2023-GLI-Challenge-TrainingData/BraTS-GLI-01222-000/BraTS-GLI-01222-000-t2w.nii.gz,../../DataSet/ASNR-MICCAI-BraTS2023-GLI-Challenge-TrainingData/BraTS-GLI-01222-000/BraTS-GLI-01222-000-t2f.nii.gz,../../DataSet/ASNR-MICCAI-BraTS2023-GLI-Challenge-TrainingData/BraTS-GLI-01222-000/BraTS-GLI-01222-000-t1n.nii.gz,../../DataSet/ASNR-MICCAI-BraTS2023-GLI-Challenge-TrainingData/BraTS-GLI-01222-000/BraTS-GLI-01222-000-seg.nii.gz,110,109,108,85,147,68,152,82,132,62,84,50
00469-001,../../DataSet/ASNR-MICCAI-BraTS2023-GLI-Challenge-TrainingData/BraTS-GLI-00469-001/BraTS-GLI-00469-001-t1c.nii.gz,../../DataSet/ASNR-MICCAI-BraTS2023-GLI-Challenge-TrainingData/BraTS-GLI-00469-001/BraTS-GLI-00469-001-t2w.nii.gz,../../DataSet/ASNR-MICCAI-BraTS2023-GLI-Challenge-TrainingData/BraTS-GLI-00469-001/BraTS-GLI-00469-001-t2f.nii.gz,../../DataSet/ASNR-MICCAI-BraTS2023-GLI-Challenge-TrainingData/BraTS-GLI-00469-001/BraTS-GLI-00469-001-t1n.nii.gz,../../DataSet/ASNR-MICCAI-BraTS2023-GLI-Challenge-TrainingData/BraTS-GLI-00469-001/BraTS-GLI-00469-001-seg.nii.gz,151,141,79,127,181,109,175,53,107,54,66,54
00999-000,../../DataSet/ASNR-MICCAI-BraTS2023-GLI-Challenge-TrainingData/BraTS-GLI-00999-000/BraTS-GLI-00999-000-t1c.nii.gz,../../DataSet/ASNR-MICCAI-BraTS2023-GLI-Challenge-TrainingData/BraTS-GLI-00999-000/BraTS-GLI-00999-000-t2w.nii.gz,../../DataSet/ASNR-MICCAI-BraTS2023-GLI-Challenge-TrainingData/BraTS-GLI-00999-000/BraTS-GLI-00999-000-t2f.nii.gz,../../DataSet/ASNR-MICCAI-BraTS2023-GLI-Challenge-TrainingData/BraTS-GLI-00999-000/BraTS-GLI-00999-000-t1n.nii.gz,../../DataSet/ASNR-MICCAI-BraTS2023-GLI-Challenge-TrainingData/BraTS-GLI-00999-000/BraTS-GLI-00999-000-seg.nii.gz,105,104,96,68,140,62,145,56,137,72,83,81
00008-001,../../DataSet/ASNR-MICCAI-BraTS2023-GLI-Challenge-TrainingData/BraTS-GLI-00008-001/BraTS-GLI-00008-001-t1c.nii.gz,../../DataSet/ASNR-MICCAI-BraTS2023-GLI-Challenge-TrainingData/BraTS-GLI-00008-001/BraTS-GLI-00008-001-t2w.nii.gz,../../DataSet/ASNR-MICCAI-BraTS2023-GLI-Challenge-TrainingData/BraTS-GLI-00008-001/BraTS-GLI-00008-001-t2f.nii.gz,../../DataSet/ASNR-MICCAI-BraTS2023-GLI-Challenge-TrainingData/BraTS-GLI-00008-001/BraTS-GLI-00008-001-t1n.nii.gz,../../DataSet/ASNR-MICCAI-BraTS2023-GLI-Challenge-TrainingData/BraTS-GLI-00008-001/BraTS-GLI-00008-001-seg.nii.gz,75,163,60,57,97,139,183,44,82,40,44,38
00313-000,../../DataSet/ASNR-MICCAI-BraTS2023-GLI-Challenge-TrainingData/BraTS-GLI-00313-000/BraTS-GLI-00313-000-t1c.nii.gz,../../DataSet/ASNR-MICCAI-BraTS2023-GLI-Challenge-TrainingData/BraTS-GLI-00313-000/BraTS-GLI-00313-000-t2w.nii.gz,../../DataSet/ASNR-MICCAI-BraTS2023-GLI-Challenge-TrainingData/BraTS-GLI-00313-000/BraTS-GLI-00313-000-t2f.nii.gz,../../DataSet/ASNR-MICCAI-BraTS2023-GLI-Challenge-TrainingData/BraTS-GLI-00313-000/BraTS-GLI-00313-000-t1n.nii.gz,../../DataSet/ASNR-MICCAI-BraTS2023-GLI-Challenge-TrainingData/BraTS-GLI-00313-000/BraTS-GLI-00313-000-seg.nii.gz,130,170,100,118,147,142,202,73,133,29,60,60
00772-000,../../DataSet/ASNR-MICCAI-BraTS2023-GLI-Challenge-TrainingData/BraTS-GLI-00772-000/BraTS-GLI-00772-000-t1c.nii.gz,../../DataSet/ASNR-MICCAI-BraTS2023-GLI-Challenge-TrainingData/BraTS-GLI-00772-000/BraTS-GLI-00772-000-t2w.nii.gz,../../DataSet/ASNR-MICCAI-BraTS2023-GLI-Challenge-TrainingData/BraTS-GLI-00772-000/BraTS-GLI-00772-000-t2f.nii.gz,../../DataSet/ASNR-MICCAI-BraTS2023-GLI-Challenge-TrainingData/BraTS-GLI-00772-000/BraTS-GLI-00772-000-t1n.nii.gz,../../DataSet/ASNR-MICCAI-BraTS2023-GLI-Challenge-TrainingData/BraTS-GLI-00772-000/BraTS-GLI-00772-000-seg.nii.gz,167,128,61,152,185,103,147,41,74,33,44,33
01132-000,../../DataSet/ASNR-MICCAI-BraTS2023-GLI-Challenge-TrainingData/BraTS-GLI-01132-000/BraTS-GLI-01132-000-t1c.nii.gz,../../DataSet/ASNR-MICCAI-BraTS2023-GLI-Challenge-TrainingData/BraTS-GLI-01132-000/BraTS-GLI-01132-000-t2w.nii.gz,../../DataSet/ASNR-MICCAI-BraTS2023-GLI-Challenge-TrainingData/BraTS-GLI-01132-000/BraTS-GLI-01132-000-t2f.nii.gz,../../DataSet/ASNR-MICCAI-BraTS2023-GLI-Challenge-TrainingData/BraTS-GLI-01132-000/BraTS-GLI-01132-000-t1n.nii.gz,../../DataSet/ASNR-MICCAI-BraTS2023-GLI-Challenge-TrainingData/BraTS-GLI-01132-000/BraTS-GLI-01132-000-seg.nii.gz,82,131,106,67,97,111,151,88,129,30,40,41
01288-000,../../DataSet/ASNR-MICCAI-BraTS2023-GLI-Challenge-TrainingData/BraTS-GLI-01288-000/BraTS-GLI-01288-000-t1c.nii.gz,../../DataSet/ASNR-MICCAI-BraTS2023-GLI-Challenge-TrainingData/BraTS-GLI-01288-000/BraTS-GLI-01288-000-t2w.nii.gz,../../DataSet/ASNR-MICCAI-BraTS2023-GLI-Challenge-TrainingData/BraTS-GLI-01288-000/BraTS-GLI-01288-000-t2f.nii.gz,../../DataSet/ASNR-MICCAI-BraTS2023-GLI-Challenge-TrainingData/BraTS-GLI-01288-000/BraTS-GLI-01288-000-t1n.nii.gz,../../DataSet/ASNR-MICCAI-BraTS2023-GLI-Challenge-TrainingData/BraTS-GLI-01288-000/BraTS-GLI-01288-000-seg.nii.gz,129,110,100,93,157,65,154,70,139,64,89,69
00078-000,../../DataSet/ASNR-MICCAI-BraTS2023-GLI-Challenge-TrainingData/BraTS-GLI-00078-000/BraTS-GLI-00078-000-t1c.nii.gz,../../DataSet/ASNR-MICCAI-BraTS2023-GLI-Challenge-TrainingData/BraTS-GLI-00078-000/BraTS-GLI-00078-000-t2w.nii.gz,../../DataSet/ASNR-MICCAI-BraTS2023-GLI-Challenge-TrainingData/BraTS-GLI-00078-000/BraTS-GLI-00078-000-t2f.nii.gz,../../DataSet/ASNR-MICCAI-BraTS2023-GLI-Challenge-TrainingData/BraTS-GLI-00078-000/BraTS-GLI-00078-000-t1n.nii.gz,../../DataSet/ASNR-MICCAI-BraTS2023-GLI-Challenge-TrainingData/BraTS-GLI-00078-000/BraTS-GLI-00078-000-seg.nii.gz,97,157,104,67,121,129,188,67,132,54,59,65
00419-000,../../DataSet/ASNR-MICCAI-BraTS2023-GLI-Challenge-TrainingData/BraTS-GLI-00419-000/BraTS-GLI-00419-000-t1c.nii.gz,../../DataSet/ASNR-MICCAI-BraTS2023-GLI-Challenge-TrainingData/BraTS-GLI-00419-000/BraTS-GLI-00419-000-t2w.nii.gz,../../DataSet/ASNR-MICCAI-BraTS2023-GLI-Challenge-TrainingData/BraTS-GLI-00419-000/BraTS-GLI-00419-000-t2f.nii.gz,../../DataSet/ASNR-MICCAI-BraTS2023-GLI-Challenge-TrainingData/BraTS-GLI-00419-000/BraTS-GLI-00419-000-t1n.nii.gz,../../DataSet/ASNR-MICCAI-BraTS2023-GLI-Challenge-TrainingData/BraTS-GLI-00419-000/BraTS-GLI-00419-000-seg.nii.gz,161,131,52,131,186,83,167,28,90,55,84,62
01259-000,../../DataSet/ASNR-MICCAI-BraTS2023-GLI-Challenge-TrainingData/BraTS-GLI-01259-000/BraTS-GLI-01259-000-t1c.nii.gz,../../DataSet/ASNR-MICCAI-BraTS2023-GLI-Challenge-TrainingData/BraTS-GLI-01259-000/BraTS-GLI-01259-000-t2w.nii.gz,../../DataSet/ASNR-MICCAI-BraTS2023-GLI-Challenge-TrainingData/BraTS-GLI-01259-000/BraTS-GLI-01259-000-t2f.nii.gz,../../DataSet/ASNR-MICCAI-BraTS2023-GLI-Challenge-TrainingData/BraTS-GLI-01259-000/BraTS-GLI-01259-000-t1n.nii.gz,../../DataSet/ASNR-MICCAI-BraTS2023-GLI-Challenge-TrainingData/BraTS-GLI-01259-000/BraTS-GLI-01259-000-seg.nii.gz,155,125,58,122,181,87,165,32,88,59,78,56
00687-000,../../DataSet/ASNR-MICCAI-BraTS2023-GLI-Challenge-TrainingData/BraTS-GLI-00687-000/BraTS-GLI-00687-000-t1c.nii.gz,../../DataSet/ASNR-MICCAI-BraTS2023-GLI-Challenge-TrainingData/BraTS-GLI-00687-000/BraTS-GLI-00687-000-t2w.nii.gz,../../DataSet/ASNR-MICCAI-BraTS2023-GLI-Challenge-TrainingData/BraTS-GLI-00687-000/BraTS-GLI-00687-000-t2f.nii.gz,../../DataSet/ASNR-MICCAI-BraTS2023-GLI-Challenge-TrainingData/BraTS-GLI-00687-000/BraTS-GLI-00687-000-t1n.nii.gz,../../DataSet/ASNR-MICCAI-BraTS2023-GLI-Challenge-TrainingData/BraTS-GLI-00687-000/BraTS-GLI-00687-000-seg.nii.gz,138,126,110,114,167,89,163,84,145,53,74,61
00120-000,../../DataSet/ASNR-MICCAI-BraTS2023-GLI-Challenge-TrainingData/BraTS-GLI-00120-000/BraTS-GLI-00120-000-t1c.nii.gz,../../DataSet/ASNR-MICCAI-BraTS2023-GLI-Challenge-TrainingData/BraTS-GLI-00120-000/BraTS-GLI-00120-000-t2w.nii.gz,../../DataSet/ASNR-MICCAI-BraTS2023-GLI-Challenge-TrainingData/BraTS-GLI-00120-000/BraTS-GLI-00120-000-t2f.nii.gz,../../DataSet/ASNR-MICCAI-BraTS2023-GLI-Challenge-TrainingData/BraTS-GLI-00120-000/BraTS-GLI-00120-000-t1n.nii.gz,../../DataSet/ASNR-MICCAI-BraTS2023-GLI-Challenge-TrainingData/BraTS-GLI-00120-000/BraTS-GLI-00120-000-seg.nii.gz,88,126,93,65,124,93,162,68,131,59,69,63
01301-000,../../DataSet/ASNR-MICCAI-BraTS2023-GLI-Challenge-TrainingData/BraTS-GLI-01301-000/BraTS-GLI-01301-000-t1c.nii.gz,../../DataSet/ASNR-MICCAI-BraTS2023-GLI-Challenge-TrainingData/BraTS-GLI-01301-000/BraTS-GLI-01301-000-t2w.nii.gz,../../DataSet/ASNR-MICCAI-BraTS2023-GLI-Challenge-TrainingData/BraTS-GLI-01301-000/BraTS-GLI-01301-000-t2f.nii.gz,../../DataSet/ASNR-MICCAI-BraTS2023-GLI-Challenge-TrainingData/BraTS-GLI-01301-000/BraTS-GLI-01301-000-t1n.nii.gz,../../DataSet/ASNR-MICCAI-BraTS2023-GLI-Challenge-TrainingData/BraTS-GLI-01301-000/BraTS-GLI-01301-000-seg.nii.gz,126,156,113,119,139,137,172,101,131,20,35,30
00237-000,../../DataSet/ASNR-MICCAI-BraTS2023-GLI-Challenge-TrainingData/BraTS-GLI-00237-000/BraTS-GLI-00237-000-t1c.nii.gz,../../DataSet/ASNR-MICCAI-BraTS2023-GLI-Challenge-TrainingData/BraTS-GLI-00237-000/BraTS-GLI-00237-000-t2w.nii.gz,../../DataSet/ASNR-MICCAI-BraTS2023-GLI-Challenge-TrainingData/BraTS-GLI-00237-000/BraTS-GLI-00237-000-t2f.nii.gz,../../DataSet/ASNR-MICCAI-BraTS2023-GLI-Challenge-TrainingData/BraTS-GLI-00237-000/BraTS-GLI-00237-000-t1n.nii.gz,../../DataSet/ASNR-MICCAI-BraTS2023-GLI-Challenge-TrainingData/BraTS-GLI-00237-000/BraTS-GLI-00237-000-seg.nii.gz,161,151,54,141,184,121,183,30,82,43,62,52
01016-000,../../DataSet/ASNR-MICCAI-BraTS2023-GLI-Challenge-TrainingData/BraTS-GLI-01016-000/BraTS-GLI-01016-000-t1c.nii.gz,../../DataSet/ASNR-MICCAI-BraTS2023-GLI-Challenge-TrainingData/BraTS-GLI-01016-000/BraTS-GLI-01016-000-t2w.nii.gz,../../DataSet/ASNR-MICCAI-BraTS2023-GLI-Challenge-TrainingData/BraTS-GLI-01016-000/BraTS-GLI-01016-000-t2f.nii.gz,../../DataSet/ASNR-MICCAI-BraTS2023-GLI-Challenge-TrainingData/BraTS-GLI-01016-000/BraTS-GLI-01016-000-t1n.nii.gz,../../DataSet/ASNR-MICCAI-BraTS2023-GLI-Challenge-TrainingData/BraTS-GLI-01016-000/BraTS-GLI-01016-000-seg.nii.gz,160,123,59,133,189,85,178,32,91,56,93,59
01210-000,../../DataSet/ASNR-MICCAI-BraTS2023-GLI-Challenge-TrainingData/BraTS-GLI-01210-000/BraTS-GLI-01210-000-t1c.nii.gz,../../DataSet/ASNR-MICCAI-BraTS2023-GLI-Challenge-TrainingData/BraTS-GLI-01210-000/BraTS-GLI-01210-000-t2w.nii.gz,../../DataSet/ASNR-MICCAI-BraTS2023-GLI-Challenge-TrainingData/BraTS-GLI-01210-000/BraTS-GLI-01210-000-t2f.nii.gz,../../DataSet/ASNR-MICCAI-BraTS2023-GLI-Challenge-TrainingData/BraTS-GLI-01210-000/BraTS-GLI-01210-000-t1n.nii.gz,../../DataSet/ASNR-MICCAI-BraTS2023-GLI-Challenge-TrainingData/BraTS-GLI-01210-000/BraTS-GLI-01210-000-seg.nii.gz,82,148,94,62,109,107,190,68,125,47,83,57
00796-000,../../DataSet/ASNR-MICCAI-BraTS2023-GLI-Challenge-TrainingData/BraTS-GLI-00796-000/BraTS-GLI-00796-000-t1c.nii.gz,../../DataSet/ASNR-MICCAI-BraTS2023-GLI-Challenge-TrainingData/BraTS-GLI-00796-000/BraTS-GLI-00796-000-t2w.nii.gz,../../DataSet/ASNR-MICCAI-BraTS2023-GLI-Challenge-TrainingData/BraTS-GLI-00796-000/BraTS-GLI-00796-000-t2f.nii.gz,../../DataSet/ASNR-MICCAI-BraTS2023-GLI-Challenge-TrainingData/BraTS-GLI-00796-000/BraTS-GLI-00796-000-t1n.nii.gz,../../DataSet/ASNR-MICCAI-BraTS2023-GLI-Challenge-TrainingData/BraTS-GLI-00796-000/BraTS-GLI-00796-000-seg.nii.gz,100,163,98,74,123,132,200,64,135,49,68,71
00747-000,../../DataSet/ASNR-MICCAI-BraTS2023-GLI-Challenge-TrainingData/BraTS-GLI-00747-000/BraTS-GLI-00747-000-t1c.nii.gz,../../DataSet/ASNR-MICCAI-BraTS2023-GLI-Challenge-TrainingData/BraTS-GLI-00747-000/BraTS-GLI-00747-000-t2w.nii.gz,../../DataSet/ASNR-MICCAI-BraTS2023-GLI-Challenge-TrainingData/BraTS-GLI-00747-000/BraTS-GLI-00747-000-t2f.nii.gz,../../DataSet/ASNR-MICCAI-BraTS2023-GLI-Challenge-TrainingData/BraTS-GLI-00747-000/BraTS-GLI-00747-000-t1n.nii.gz,../../DataSet/ASNR-MICCAI-BraTS2023-GLI-Challenge-TrainingData/BraTS-GLI-00747-000/BraTS-GLI-00747-000-seg.nii.gz,98,151,92,59,123,119,182,62,130,64,63,68
01107-000,../../DataSet/ASNR-MICCAI-BraTS2023-GLI-Challenge-TrainingData/BraTS-GLI-01107-000/BraTS-GLI-01107-000-t1c.nii.gz,../../DataSet/ASNR-MICCAI-BraTS2023-GLI-Challenge-TrainingData/BraTS-GLI-01107-000/BraTS-GLI-01107-000-t2w.nii.gz,../../DataSet/ASNR-MICCAI-BraTS2023-GLI-Challenge-TrainingData/BraTS-GLI-01107-000/BraTS-GLI-01107-000-t2f.nii.gz,../../DataSet/ASNR-MICCAI-BraTS2023-GLI-Challenge-TrainingData/BraTS-GLI-01107-000/BraTS-GLI-01107-000-t1n.nii.gz,../../DataSet/ASNR-MICCAI-BraTS2023-GLI-Challenge-TrainingData/BraTS-GLI-01107-000/BraTS-GLI-01107-000-seg.nii.gz,160,114,54,133,186,79,159,26,80,53,80,54
00481-000,../../DataSet/ASNR-MICCAI-BraTS2023-GLI-Challenge-TrainingData/BraTS-GLI-00481-000/BraTS-GLI-00481-000-t1c.nii.gz,../../DataSet/ASNR-MICCAI-BraTS2023-GLI-Challenge-TrainingData/BraTS-GLI-00481-000/BraTS-GLI-00481-000-t2w.nii.gz,../../DataSet/ASNR-MICCAI-BraTS2023-GLI-Challenge-TrainingData/BraTS-GLI-00481-000/BraTS-GLI-00481-000-t2f.nii.gz,../../DataSet/ASNR-MICCAI-BraTS2023-GLI-Challenge-TrainingData/BraTS-GLI-00481-000/BraTS-GLI-00481-000-t1n.nii.gz,../../DataSet/ASNR-MICCAI-BraTS2023-GLI-Challenge-TrainingData/BraTS-GLI-00481-000/BraTS-GLI-00481-000-seg.nii.gz,99,81,94,69,133,37,120,59,138,64,83,79
01399-000,../../DataSet/ASNR-MICCAI-BraTS2023-GLI-Challenge-TrainingData/BraTS-GLI-01399-000/BraTS-GLI-01399-000-t1c.nii.gz,../../DataSet/ASNR-MICCAI-BraTS2023-GLI-Challenge-TrainingData/BraTS-GLI-01399-000/BraTS-GLI-01399-000-t2w.nii.gz,../../DataSet/ASNR-MICCAI-BraTS2023-GLI-Challenge-TrainingData/BraTS-GLI-01399-000/BraTS-GLI-01399-000-t2f.nii.gz,../../DataSet/ASNR-MICCAI-BraTS2023-GLI-Challenge-TrainingData/BraTS-GLI-01399-000/BraTS-GLI-01399-000-t1n.nii.gz,../../DataSet/ASNR-MICCAI-BraTS2023-GLI-Challenge-TrainingData/BraTS-GLI-01399-000/BraTS-GLI-01399-000-seg.nii.gz,158,164,79,126,181,123,196,41,135,55,73,94
01348-000,../../DataSet/ASNR-MICCAI-BraTS2023-GLI-Challenge-TrainingData/BraTS-GLI-01348-000/BraTS-GLI-01348-000-t1c.nii.gz,../../DataSet/ASNR-MICCAI-BraTS2023-GLI-Challenge-TrainingData/BraTS-GLI-01348-000/BraTS-GLI-01348-000-t2w.nii.gz,../../DataSet/ASNR-MICCAI-BraTS2023-GLI-Challenge-TrainingData/BraTS-GLI-01348-000/BraTS-GLI-01348-000-t2f.nii.gz,../../DataSet/ASNR-MICCAI-BraTS2023-GLI-Challenge-TrainingData/BraTS-GLI-01348-000/BraTS-GLI-01348-000-t1n.nii.gz,../../DataSet/ASNR-MICCAI-BraTS2023-GLI-Challenge-TrainingData/BraTS-GLI-01348-000/BraTS-GLI-01348-000-seg.nii.gz,149,155,103,130,169,108,186,79,133,39,78,54
00663-000,../../DataSet/ASNR-MICCAI-BraTS2023-GLI-Challenge-TrainingData/BraTS-GLI-00663-000/BraTS-GLI-00663-000-t1c.nii.gz,../../DataSet/ASNR-MICCAI-BraTS2023-GLI-Challenge-TrainingData/BraTS-GLI-00663-000/BraTS-GLI-00663-000-t2w.nii.gz,../../DataSet/ASNR-MICCAI-BraTS2023-GLI-Challenge-TrainingData/BraTS-GLI-00663-000/BraTS-GLI-00663-000-t2f.nii.gz,../../DataSet/ASNR-MICCAI-BraTS2023-GLI-Challenge-TrainingData/BraTS-GLI-00663-000/BraTS-GLI-00663-000-t1n.nii.gz,../../DataSet/ASNR-MICCAI-BraTS2023-GLI-Challenge-TrainingData/BraTS-GLI-00663-000/BraTS-GLI-00663-000-seg.nii.gz,78,144,79,48,111,101,193,34,126,63,92,92
01023-000,../../DataSet/ASNR-MICCAI-BraTS2023-GLI-Challenge-TrainingData/BraTS-GLI-01023-000/BraTS-GLI-01023-000-t1c.nii.gz,../../DataSet/ASNR-MICCAI-BraTS2023-GLI-Challenge-TrainingData/BraTS-GLI-01023-000/BraTS-GLI-01023-000-t2w.nii.gz,../../DataSet/ASNR-MICCAI-BraTS2023-GLI-Challenge-TrainingData/BraTS-GLI-01023-000/BraTS-GLI-01023-000-t2f.nii.gz,../../DataSet/ASNR-MICCAI-BraTS2023-GLI-Challenge-TrainingData/BraTS-GLI-01023-000/BraTS-GLI-01023-000-t1n.nii.gz,../../DataSet/ASNR-MICCAI-BraTS2023-GLI-Challenge-TrainingData/BraTS-GLI-01023-000/BraTS-GLI-01023-000-seg.nii.gz,85,146,97,54,114,115,176,65,132,60,61,67
01442-000,../../DataSet/ASNR-MICCAI-BraTS2023-GLI-Challenge-TrainingData/BraTS-GLI-01442-000/BraTS-GLI-01442-000-t1c.nii.gz,../../DataSet/ASNR-MICCAI-BraTS2023-GLI-Challenge-TrainingData/BraTS-GLI-01442-000/BraTS-GLI-01442-000-t2w.nii.gz,../../DataSet/ASNR-MICCAI-BraTS2023-GLI-Challenge-TrainingData/BraTS-GLI-01442-000/BraTS-GLI-01442-000-t2f.nii.gz,../../DataSet/ASNR-MICCAI-BraTS2023-GLI-Challenge-TrainingData/BraTS-GLI-01442-000/BraTS-GLI-01442-000-t1n.nii.gz,../../DataSet/ASNR-MICCAI-BraTS2023-GLI-Challenge-TrainingData/BraTS-GLI-01442-000/BraTS-GLI-01442-000-seg.nii.gz,159,134,66,128,185,94,173,39,98,57,79,59
01334-000,../../DataSet/ASNR-MICCAI-BraTS2023-GLI-Challenge-TrainingData/BraTS-GLI-01334-000/BraTS-GLI-01334-000-t1c.nii.gz,../../DataSet/ASNR-MICCAI-BraTS2023-GLI-Challenge-TrainingData/BraTS-GLI-01334-000/BraTS-GLI-01334-000-t2w.nii.gz,../../DataSet/ASNR-MICCAI-BraTS2023-GLI-Challenge-TrainingData/BraTS-GLI-01334-000/BraTS-GLI-01334-000-t2f.nii.gz,../../DataSet/ASNR-MICCAI-BraTS2023-GLI-Challenge-TrainingData/BraTS-GLI-01334-000/BraTS-GLI-01334-000-t1n.nii.gz,../../DataSet/ASNR-MICCAI-BraTS2023-GLI-Challenge-TrainingData/BraTS-GLI-01334-000/BraTS-GLI-01334-000-seg.nii.gz,81,142,92,56,107,103,179,69,119,51,76,50
01493-000,../../DataSet/ASNR-MICCAI-BraTS2023-GLI-Challenge-TrainingData/BraTS-GLI-01493-000/BraTS-GLI-01493-000-t1c.nii.gz,../../DataSet/ASNR-MICCAI-BraTS2023-GLI-Challenge-TrainingData/BraTS-GLI-01493-000/BraTS-GLI-01493-000-t2w.nii.gz,../../DataSet/ASNR-MICCAI-BraTS2023-GLI-Challenge-TrainingData/BraTS-GLI-01493-000/BraTS-GLI-01493-000-t2f.nii.gz,../../DataSet/ASNR-MICCAI-BraTS2023-GLI-Challenge-TrainingData/BraTS-GLI-01493-000/BraTS-GLI-01493-000-t1n.nii.gz,../../DataSet/ASNR-MICCAI-BraTS2023-GLI-Challenge-TrainingData/BraTS-GLI-01493-000/BraTS-GLI-01493-000-seg.nii.gz,76,134,49,52,100,96,173,23,78,48,77,55
00730-001,../../DataSet/ASNR-MICCAI-BraTS2023-GLI-Challenge-TrainingData/BraTS-GLI-00730-001/BraTS-GLI-00730-001-t1c.nii.gz,../../DataSet/ASNR-MICCAI-BraTS2023-GLI-Challenge-TrainingData/BraTS-GLI-00730-001/BraTS-GLI-00730-001-t2w.nii.gz,../../DataSet/ASNR-MICCAI-BraTS2023-GLI-Challenge-TrainingData/BraTS-GLI-00730-001/BraTS-GLI-00730-001-t2f.nii.gz,../../DataSet/ASNR-MICCAI-BraTS2023-GLI-Challenge-TrainingData/BraTS-GLI-00730-001/BraTS-GLI-00730-001-t1n.nii.gz,../../DataSet/ASNR-MICCAI-BraTS2023-GLI-Challenge-TrainingData/BraTS-GLI-00730-001/BraTS-GLI-00730-001-seg.nii.gz,91,139,104,58,119,111,173,76,135,61,62,59
00115-000,../../DataSet/ASNR-MICCAI-BraTS2023-GLI-Challenge-TrainingData/BraTS-GLI-00115-000/BraTS-GLI-00115-000-t1c.nii.gz,../../DataSet/ASNR-MICCAI-BraTS2023-GLI-Challenge-TrainingData/BraTS-GLI-00115-000/BraTS-GLI-00115-000-t2w.nii.gz,../../DataSet/ASNR-MICCAI-BraTS2023-GLI-Challenge-TrainingData/BraTS-GLI-00115-000/BraTS-GLI-00115-000-t2f.nii.gz,../../DataSet/ASNR-MICCAI-BraTS2023-GLI-Challenge-TrainingData/BraTS-GLI-00115-000/BraTS-GLI-00115-000-t1n.nii.gz,../../DataSet/ASNR-MICCAI-BraTS2023-GLI-Challenge-TrainingData/BraTS-GLI-00115-000/BraTS-GLI-00115-000-seg.nii.gz,82,162,82,57,148,123,197,49,117,91,74,68
00097-001,../../DataSet/ASNR-MICCAI-BraTS2023-GLI-Challenge-TrainingData/BraTS-GLI-00097-001/BraTS-GLI-00097-001-t1c.nii.gz,../../DataSet/ASNR-MICCAI-BraTS2023-GLI-Challenge-TrainingData/BraTS-GLI-00097-001/BraTS-GLI-00097-001-t2w.nii.gz,../../DataSet/ASNR-MICCAI-BraTS2023-GLI-Challenge-TrainingData/BraTS-GLI-00097-001/BraTS-GLI-00097-001-t2f.nii.gz,../../DataSet/ASNR-MICCAI-BraTS2023-GLI-Challenge-TrainingData/BraTS-GLI-00097-001/BraTS-GLI-00097-001-t1n.nii.gz,../../DataSet/ASNR-MICCAI-BraTS2023-GLI-Challenge-TrainingData/BraTS-GLI-00097-001/BraTS-GLI-00097-001-seg.nii.gz,164,153,89,146,180,134,174,71,111,34,40,40
01024-000,../../DataSet/ASNR-MICCAI-BraTS2023-GLI-Challenge-TrainingData/BraTS-GLI-01024-000/BraTS-GLI-01024-000-t1c.nii.gz,../../DataSet/ASNR-MICCAI-BraTS2023-GLI-Challenge-TrainingData/BraTS-GLI-01024-000/BraTS-GLI-01024-000-t2w.nii.gz,../../DataSet/ASNR-MICCAI-BraTS2023-GLI-Challenge-TrainingData/BraTS-GLI-01024-000/BraTS-GLI-01024-000-t2f.nii.gz,../../DataSet/ASNR-MICCAI-BraTS2023-GLI-Challenge-TrainingData/BraTS-GLI-01024-000/BraTS-GLI-01024-000-t1n.nii.gz,../../DataSet/ASNR-MICCAI-BraTS2023-GLI-Challenge-TrainingData/BraTS-GLI-01024-000/BraTS-GLI-01024-000-seg.nii.gz,162,106,91,142,182,78,140,50,118,40,62,68
01445-000,../../DataSet/ASNR-MICCAI-BraTS2023-GLI-Challenge-TrainingData/BraTS-GLI-01445-000/BraTS-GLI-01445-000-t1c.nii.gz,../../DataSet/ASNR-MICCAI-BraTS2023-GLI-Challenge-TrainingData/BraTS-GLI-01445-000/BraTS-GLI-01445-000-t2w.nii.gz,../../DataSet/ASNR-MICCAI-BraTS2023-GLI-Challenge-TrainingData/BraTS-GLI-01445-000/BraTS-GLI-01445-000-t2f.nii.gz,../../DataSet/ASNR-MICCAI-BraTS2023-GLI-Challenge-TrainingData/BraTS-GLI-01445-000/BraTS-GLI-01445-000-t1n.nii.gz,../../DataSet/ASNR-MICCAI-BraTS2023-GLI-Challenge-TrainingData/BraTS-GLI-01445-000/BraTS-GLI-01445-000-seg.nii.gz,96,89,86,66,128,46,128,52,124,62,82,72
00090-001,../../DataSet/ASNR-MICCAI-BraTS2023-GLI-Challenge-TrainingData/BraTS-GLI-00090-001/BraTS-GLI-00090-001-t1c.nii.gz,../../DataSet/ASNR-MICCAI-BraTS2023-GLI-Challenge-TrainingData/BraTS-GLI-00090-001/BraTS-GLI-00090-001-t2w.nii.gz,../../DataSet/ASNR-MICCAI-BraTS2023-GLI-Challenge-TrainingData/BraTS-GLI-00090-001/BraTS-GLI-00090-001-t2f.nii.gz,../../DataSet/ASNR-MICCAI-BraTS2023-GLI-Challenge-TrainingData/BraTS-GLI-00090-001/BraTS-GLI-00090-001-t1n.nii.gz,../../DataSet/ASNR-MICCAI-BraTS2023-GLI-Challenge-TrainingData/BraTS-GLI-00090-001/BraTS-GLI-00090-001-seg.nii.gz,153,137,66,119,184,100,172,28,97,65,72,69
00112-000,../../DataSet/ASNR-MICCAI-BraTS2023-GLI-Challenge-TrainingData/BraTS-GLI-00112-000/BraTS-GLI-00112-000-t1c.nii.gz,../../DataSet/ASNR-MICCAI-BraTS2023-GLI-Challenge-TrainingData/BraTS-GLI-00112-000/BraTS-GLI-00112-000-t2w.nii.gz,../../DataSet/ASNR-MICCAI-BraTS2023-GLI-Challenge-TrainingData/BraTS-GLI-00112-000/BraTS-GLI-00112-000-t2f.nii.gz,../../DataSet/ASNR-MICCAI-BraTS2023-GLI-Challenge-TrainingData/BraTS-GLI-00112-000/BraTS-GLI-00112-000-t1n.nii.gz,../../DataSet/ASNR-MICCAI-BraTS2023-GLI-Challenge-TrainingData/BraTS-GLI-00112-000/BraTS-GLI-00112-000-seg.nii.gz,159,169,65,133,187,125,210,36,100,54,85,64
01217-000,../../DataSet/ASNR-MICCAI-BraTS2023-GLI-Challenge-TrainingData/BraTS-GLI-01217-000/BraTS-GLI-01217-000-t1c.nii.gz,../../DataSet/ASNR-MICCAI-BraTS2023-GLI-Challenge-TrainingData/BraTS-GLI-01217-000/BraTS-GLI-01217-000-t2w.nii.gz,../../DataSet/ASNR-MICCAI-BraTS2023-GLI-Challenge-TrainingData/BraTS-GLI-01217-000/BraTS-GLI-01217-000-t2f.nii.gz,../../DataSet/ASNR-MICCAI-BraTS2023-GLI-Challenge-TrainingData/BraTS-GLI-01217-000/BraTS-GLI-01217-000-t1n.nii.gz,../../DataSet/ASNR-MICCAI-BraTS2023-GLI-Challenge-TrainingData/BraTS-GLI-01217-000/BraTS-GLI-01217-000-seg.nii.gz,160,141,77,130,189,97,180,41,119,59,83,78
00457-000,../../DataSet/ASNR-MICCAI-BraTS2023-GLI-Challenge-TrainingData/BraTS-GLI-00457-000/BraTS-GLI-00457-000-t1c.nii.gz,../../DataSet/ASNR-MICCAI-BraTS2023-GLI-Challenge-TrainingData/BraTS-GLI-00457-000/BraTS-GLI-00457-000-t2w.nii.gz,../../DataSet/ASNR-MICCAI-BraTS2023-GLI-Challenge-TrainingData/BraTS-GLI-00457-000/BraTS-GLI-00457-000-t2f.nii.gz,../../DataSet/ASNR-MICCAI-BraTS2023-GLI-Challenge-TrainingData/BraTS-GLI-00457-000/BraTS-GLI-00457-000-t1n.nii.gz,../../DataSet/ASNR-MICCAI-BraTS2023-GLI-Challenge-TrainingData/BraTS-GLI-00457-000/BraTS-GLI-00457-000-seg.nii.gz,158,124,63,133,182,87,177,31,94,49,90,63
00791-000,../../DataSet/ASNR-MICCAI-BraTS2023-GLI-Challenge-TrainingData/BraTS-GLI-00791-000/BraTS-GLI-00791-000-t1c.nii.gz,../../DataSet/ASNR-MICCAI-BraTS2023-GLI-Challenge-TrainingData/BraTS-GLI-00791-000/BraTS-GLI-00791-000-t2w.nii.gz,../../DataSet/ASNR-MICCAI-BraTS2023-GLI-Challenge-TrainingData/BraTS-GLI-00791-000/BraTS-GLI-00791-000-t2f.nii.gz,../../DataSet/ASNR-MICCAI-BraTS2023-GLI-Challenge-TrainingData/BraTS-GLI-00791-000/BraTS-GLI-00791-000-t1n.nii.gz,../../DataSet/ASNR-MICCAI-BraTS2023-GLI-Challenge-TrainingData/BraTS-GLI-00791-000/BraTS-GLI-00791-000-seg.nii.gz,153,167,78,125,184,129,210,47,118,59,81,71
01100-000,../../DataSet/ASNR-MICCAI-BraTS2023-GLI-Challenge-TrainingData/BraTS-GLI-01100-000/BraTS-GLI-01100-000-t1c.nii.gz,../../DataSet/ASNR-MICCAI-BraTS2023-GLI-Challenge-TrainingData/BraTS-GLI-01100-000/BraTS-GLI-01100-000-t2w.nii.gz,../../DataSet/ASNR-MICCAI-BraTS2023-GLI-Challenge-TrainingData/BraTS-GLI-01100-000/BraTS-GLI-01100-000-t2f.nii.gz,../../DataSet/ASNR-MICCAI-BraTS2023-GLI-Challenge-TrainingData/BraTS-GLI-01100-000/BraTS-GLI-01100-000-t1n.nii.gz,../../DataSet/ASNR-MICCAI-BraTS2023-GLI-Challenge-TrainingData/BraTS-GLI-01100-000/BraTS-GLI-01100-000-seg.nii.gz,149,169,68,122,178,117,209,45,99,56,92,54
00740-000,../../DataSet/ASNR-MICCAI-BraTS2023-GLI-Challenge-TrainingData/BraTS-GLI-00740-000/BraTS-GLI-00740-000-t1c.nii.gz,../../DataSet/ASNR-MICCAI-BraTS2023-GLI-Challenge-TrainingData/BraTS-GLI-00740-000/BraTS-GLI-00740-000-t2w.nii.gz,../../DataSet/ASNR-MICCAI-BraTS2023-GLI-Challenge-TrainingData/BraTS-GLI-00740-000/BraTS-GLI-00740-000-t2f.nii.gz,../../DataSet/ASNR-MICCAI-BraTS2023-GLI-Challenge-TrainingData/BraTS-GLI-00740-000/BraTS-GLI-00740-000-t1n.nii.gz,../../DataSet/ASNR-MICCAI-BraTS2023-GLI-Challenge-TrainingData/BraTS-GLI-00740-000/BraTS-GLI-00740-000-seg.nii.gz,155,155,87,122,182,120,197,60,120,60,77,60
00321-000,../../DataSet/ASNR-MICCAI-BraTS2023-GLI-Challenge-TrainingData/BraTS-GLI-00321-000/BraTS-GLI-00321-000-t1c.nii.gz,../../DataSet/ASNR-MICCAI-BraTS2023-GLI-Challenge-TrainingData/BraTS-GLI-00321-000/BraTS-GLI-00321-000-t2w.nii.gz,../../DataSet/ASNR-MICCAI-BraTS2023-GLI-Challenge-TrainingData/BraTS-GLI-00321-000/BraTS-GLI-00321-000-t2f.nii.gz,../../DataSet/ASNR-MICCAI-BraTS2023-GLI-Challenge-TrainingData/BraTS-GLI-00321-000/BraTS-GLI-00321-000-t1n.nii.gz,../../DataSet/ASNR-MICCAI-BraTS2023-GLI-Challenge-TrainingData/BraTS-GLI-00321-000/BraTS-GLI-00321-000-seg.nii.gz,62,123,52,51,84,89,159,25,71,33,70,46
01058-000,../../DataSet/ASNR-MICCAI-BraTS2023-GLI-Challenge-TrainingData/BraTS-GLI-01058-000/BraTS-GLI-01058-000-t1c.nii.gz,../../DataSet/ASNR-MICCAI-BraTS2023-GLI-Challenge-TrainingData/BraTS-GLI-01058-000/BraTS-GLI-01058-000-t2w.nii.gz,../../DataSet/ASNR-MICCAI-BraTS2023-GLI-Challenge-TrainingData/BraTS-GLI-01058-000/BraTS-GLI-01058-000-t2f.nii.gz,../../DataSet/ASNR-MICCAI-BraTS2023-GLI-Challenge-TrainingData/BraTS-GLI-01058-000/BraTS-GLI-01058-000-t1n.nii.gz,../../DataSet/ASNR-MICCAI-BraTS2023-GLI-Challenge-TrainingData/BraTS-GLI-01058-000/BraTS-GLI-01058-000-seg.nii.gz,86,158,64,55,120,110,203,38,104,65,93,66
01439-000,../../DataSet/ASNR-MICCAI-BraTS2023-GLI-Challenge-TrainingData/BraTS-GLI-01439-000/BraTS-GLI-01439-000-t1c.nii.gz,../../DataSet/ASNR-MICCAI-BraTS2023-GLI-Challenge-TrainingData/BraTS-GLI-01439-000/BraTS-GLI-01439-000-t2w.nii.gz,../../DataSet/ASNR-MICCAI-BraTS2023-GLI-Challenge-TrainingData/BraTS-GLI-01439-000/BraTS-GLI-01439-000-t2f.nii.gz,../../DataSet/ASNR-MICCAI-BraTS2023-GLI-Challenge-TrainingData/BraTS-GLI-01439-000/BraTS-GLI-01439-000-t1n.nii.gz,../../DataSet/ASNR-MICCAI-BraTS2023-GLI-Challenge-TrainingData/BraTS-GLI-01439-000/BraTS-GLI-01439-000-seg.nii.gz,79,142,55,65,98,113,165,43,69,33,52,26
00425-000,../../DataSet/ASNR-MICCAI-BraTS2023-GLI-Challenge-TrainingData/BraTS-GLI-00425-000/BraTS-GLI-00425-000-t1c.nii.gz,../../DataSet/ASNR-MICCAI-BraTS2023-GLI-Challenge-TrainingData/BraTS-GLI-00425-000/BraTS-GLI-00425-000-t2w.nii.gz,../../DataSet/ASNR-MICCAI-BraTS2023-GLI-Challenge-TrainingData/BraTS-GLI-00425-000/BraTS-GLI-00425-000-t2f.nii.gz,../../DataSet/ASNR-MICCAI-BraTS2023-GLI-Challenge-TrainingData/BraTS-GLI-00425-000/BraTS-GLI-00425-000-t1n.nii.gz,../../DataSet/ASNR-MICCAI-BraTS2023-GLI-Challenge-TrainingData/BraTS-GLI-00425-000/BraTS-GLI-00425-000-seg.nii.gz,80,110,64,67,94,85,138,46,85,27,53,39
01265-000,../../DataSet/ASNR-MICCAI-BraTS2023-GLI-Challenge-TrainingData/BraTS-GLI-01265-000/BraTS-GLI-01265-000-t1c.nii.gz,../../DataSet/ASNR-MICCAI-BraTS2023-GLI-Challenge-TrainingData/BraTS-GLI-01265-000/BraTS-GLI-01265-000-t2w.nii.gz,../../DataSet/ASNR-MICCAI-BraTS2023-GLI-Challenge-TrainingData/BraTS-GLI-01265-000/BraTS-GLI-01265-000-t2f.nii.gz,../../DataSet/ASNR-MICCAI-BraTS2023-GLI-Challenge-TrainingData/BraTS-GLI-01265-000/BraTS-GLI-01265-000-t1n.nii.gz,../../DataSet/ASNR-MICCAI-BraTS2023-GLI-Challenge-TrainingData/BraTS-GLI-01265-000/BraTS-GLI-01265-000-seg.nii.gz,153,177,71,83,177,139,206,48,106,94,67,58
00044-000,../../DataSet/ASNR-MICCAI-BraTS2023-GLI-Challenge-TrainingData/BraTS-GLI-00044-000/BraTS-GLI-00044-000-t1c.nii.gz,../../DataSet/ASNR-MICCAI-BraTS2023-GLI-Challenge-TrainingData/BraTS-GLI-00044-000/BraTS-GLI-00044-000-t2w.nii.gz,../../DataSet/ASNR-MICCAI-BraTS2023-GLI-Challenge-TrainingData/BraTS-GLI-00044-000/BraTS-GLI-00044-000-t2f.nii.gz,../../DataSet/ASNR-MICCAI-BraTS2023-GLI-Challenge-TrainingData/BraTS-GLI-00044-000/BraTS-GLI-00044-000-t1n.nii.gz,../../DataSet/ASNR-MICCAI-BraTS2023-GLI-Challenge-TrainingData/BraTS-GLI-00044-000/BraTS-GLI-00044-000-seg.nii.gz,161,116,87,147,177,99,134,71,108,30,35,37
00732-000,../../DataSet/ASNR-MICCAI-BraTS2023-GLI-Challenge-TrainingData/BraTS-GLI-00732-000/BraTS-GLI-00732-000-t1c.nii.gz,../../DataSet/ASNR-MICCAI-BraTS2023-GLI-Challenge-TrainingData/BraTS-GLI-00732-000/BraTS-GLI-00732-000-t2w.nii.gz,../../DataSet/ASNR-MICCAI-BraTS2023-GLI-Challenge-TrainingData/BraTS-GLI-00732-000/BraTS-GLI-00732-000-t2f.nii.gz,../../DataSet/ASNR-MICCAI-BraTS2023-GLI-Challenge-TrainingData/BraTS-GLI-00732-000/BraTS-GLI-00732-000-t1n.nii.gz,../../DataSet/ASNR-MICCAI-BraTS2023-GLI-Challenge-TrainingData/BraTS-GLI-00732-000/BraTS-GLI-00732-000-seg.nii.gz,167,143,57,153,180,120,189,46,70,27,69,24
01172-000,../../DataSet/ASNR-MICCAI-BraTS2023-GLI-Challenge-TrainingData/BraTS-GLI-01172-000/BraTS-GLI-01172-000-t1c.nii.gz,../../DataSet/ASNR-MICCAI-BraTS2023-GLI-Challenge-TrainingData/BraTS-GLI-01172-000/BraTS-GLI-01172-000-t2w.nii.gz,../../DataSet/ASNR-MICCAI-BraTS2023-GLI-Challenge-TrainingData/BraTS-GLI-01172-000/BraTS-GLI-01172-000-t2f.nii.gz,../../DataSet/ASNR-MICCAI-BraTS2023-GLI-Challenge-TrainingData/BraTS-GLI-01172-000/BraTS-GLI-01172-000-t1n.nii.gz,../../DataSet/ASNR-MICCAI-BraTS2023-GLI-Challenge-TrainingData/BraTS-GLI-01172-000/BraTS-GLI-01172-000-seg.nii.gz,157,153,82,117,183,116,190,43,121,66,74,78
00353-000,../../DataSet/ASNR-MICCAI-BraTS2023-GLI-Challenge-TrainingData/BraTS-GLI-00353-000/BraTS-GLI-00353-000-t1c.nii.gz,../../DataSet/ASNR-MICCAI-BraTS2023-GLI-Challenge-TrainingData/BraTS-GLI-00353-000/BraTS-GLI-00353-000-t2w.nii.gz,../../DataSet/ASNR-MICCAI-BraTS2023-GLI-Challenge-TrainingData/BraTS-GLI-00353-000/BraTS-GLI-00353-000-t2f.nii.gz,../../DataSet/ASNR-MICCAI-BraTS2023-GLI-Challenge-TrainingData/BraTS-GLI-00353-000/BraTS-GLI-00353-000-t1n.nii.gz,../../DataSet/ASNR-MICCAI-BraTS2023-GLI-Challenge-TrainingData/BraTS-GLI-00353-000/BraTS-GLI-00353-000-seg.nii.gz,144,101,107,122,173,65,139,77,138,51,74,61
00459-000,../../DataSet/ASNR-MICCAI-BraTS2023-GLI-Challenge-TrainingData/BraTS-GLI-00459-000/BraTS-GLI-00459-000-t1c.nii.gz,../../DataSet/ASNR-MICCAI-BraTS2023-GLI-Challenge-TrainingData/BraTS-GLI-00459-000/BraTS-GLI-00459-000-t2w.nii.gz,../../DataSet/ASNR-MICCAI-BraTS2023-GLI-Challenge-TrainingData/BraTS-GLI-00459-000/BraTS-GLI-00459-000-t2f.nii.gz,../../DataSet/ASNR-MICCAI-BraTS2023-GLI-Challenge-TrainingData/BraTS-GLI-00459-000/BraTS-GLI-00459-000-t1n.nii.gz,../../DataSet/ASNR-MICCAI-BraTS2023-GLI-Challenge-TrainingData/BraTS-GLI-00459-000/BraTS-GLI-00459-000-seg.nii.gz,154,114,64,122,182,85,148,37,93,60,63,56
00488-000,../../DataSet/ASNR-MICCAI-BraTS2023-GLI-Challenge-TrainingData/BraTS-GLI-00488-000/BraTS-GLI-00488-000-t1c.nii.gz,../../DataSet/ASNR-MICCAI-BraTS2023-GLI-Challenge-TrainingData/BraTS-GLI-00488-000/BraTS-GLI-00488-000-t2w.nii.gz,../../DataSet/ASNR-MICCAI-BraTS2023-GLI-Challenge-TrainingData/BraTS-GLI-00488-000/BraTS-GLI-00488-000-t2f.nii.gz,../../DataSet/ASNR-MICCAI-BraTS2023-GLI-Challenge-TrainingData/BraTS-GLI-00488-000/BraTS-GLI-00488-000-t1n.nii.gz,../../DataSet/ASNR-MICCAI-BraTS2023-GLI-Challenge-TrainingData/BraTS-GLI-00488-000/BraTS-GLI-00488-000-seg.nii.gz,101,156,90,82,125,128,192,66,125,43,64,59
01390-000,../../DataSet/ASNR-MICCAI-BraTS2023-GLI-Challenge-TrainingData/BraTS-GLI-01390-000/BraTS-GLI-01390-000-t1c.nii.gz,../../DataSet/ASNR-MICCAI-BraTS2023-GLI-Challenge-TrainingData/BraTS-GLI-01390-000/BraTS-GLI-01390-000-t2w.nii.gz,../../DataSet/ASNR-MICCAI-BraTS2023-GLI-Challenge-TrainingData/BraTS-GLI-01390-000/BraTS-GLI-01390-000-t2f.nii.gz,../../DataSet/ASNR-MICCAI-BraTS2023-GLI-Challenge-TrainingData/BraTS-GLI-01390-000/BraTS-GLI-01390-000-t1n.nii.gz,../../DataSet/ASNR-MICCAI-BraTS2023-GLI-Challenge-TrainingData/BraTS-GLI-01390-000/BraTS-GLI-01390-000-seg.nii.gz,93,138,97,71,121,109,169,65,129,50,60,64
01437-000,../../DataSet/ASNR-MICCAI-BraTS2023-GLI-Challenge-TrainingData/BraTS-GLI-01437-000/BraTS-GLI-01437-000-t1c.nii.gz,../../DataSet/ASNR-MICCAI-BraTS2023-GLI-Challenge-TrainingData/BraTS-GLI-01437-000/BraTS-GLI-01437-000-t2w.nii.gz,../../DataSet/ASNR-MICCAI-BraTS2023-GLI-Challenge-TrainingData/BraTS-GLI-01437-000/BraTS-GLI-01437-000-t2f.nii.gz,../../DataSet/ASNR-MICCAI-BraTS2023-GLI-Challenge-TrainingData/BraTS-GLI-01437-000/BraTS-GLI-01437-000-t1n.nii.gz,../../DataSet/ASNR-MICCAI-BraTS2023-GLI-Challenge-TrainingData/BraTS-GLI-01437-000/BraTS-GLI-01437-000-seg.nii.gz,155,114,100,132,179,83,145,76,124,47,62,48
00501-000,../../DataSet/ASNR-MICCAI-BraTS2023-GLI-Challenge-TrainingData/BraTS-GLI-00501-000/BraTS-GLI-00501-000-t1c.nii.gz,../../DataSet/ASNR-MICCAI-BraTS2023-GLI-Challenge-TrainingData/BraTS-GLI-00501-000/BraTS-GLI-00501-000-t2w.nii.gz,../../DataSet/ASNR-MICCAI-BraTS2023-GLI-Challenge-TrainingData/BraTS-GLI-00501-000/BraTS-GLI-00501-000-t2f.nii.gz,../../DataSet/ASNR-MICCAI-BraTS2023-GLI-Challenge-TrainingData/BraTS-GLI-00501-000/BraTS-GLI-00501-000-t1n.nii.gz,../../DataSet/ASNR-MICCAI-BraTS2023-GLI-Challenge-TrainingData/BraTS-GLI-00501-000/BraTS-GLI-00501-000-seg.nii.gz,149,111,74,109,185,69,159,35,116,76,90,81
00483-001,../../DataSet/ASNR-MICCAI-BraTS2023-GLI-Challenge-TrainingData/BraTS-GLI-00483-001/BraTS-GLI-00483-001-t1c.nii.gz,../../DataSet/ASNR-MICCAI-BraTS2023-GLI-Challenge-TrainingData/BraTS-GLI-00483-001/BraTS-GLI-00483-001-t2w.nii.gz,../../DataSet/ASNR-MICCAI-BraTS2023-GLI-Challenge-TrainingData/BraTS-GLI-00483-001/BraTS-GLI-00483-001-t2f.nii.gz,../../DataSet/ASNR-MICCAI-BraTS2023-GLI-Challenge-TrainingData/BraTS-GLI-00483-001/BraTS-GLI-00483-001-t1n.nii.gz,../../DataSet/ASNR-MICCAI-BraTS2023-GLI-Challenge-TrainingData/BraTS-GLI-00483-001/BraTS-GLI-00483-001-seg.nii.gz,90,132,76,54,129,87,179,35,116,75,92,81
01341-000,../../DataSet/ASNR-MICCAI-BraTS2023-GLI-Challenge-TrainingData/BraTS-GLI-01341-000/BraTS-GLI-01341-000-t1c.nii.gz,../../DataSet/ASNR-MICCAI-BraTS2023-GLI-Challenge-TrainingData/BraTS-GLI-01341-000/BraTS-GLI-01341-000-t2w.nii.gz,../../DataSet/ASNR-MICCAI-BraTS2023-GLI-Challenge-TrainingData/BraTS-GLI-01341-000/BraTS-GLI-01341-000-t2f.nii.gz,../../DataSet/ASNR-MICCAI-BraTS2023-GLI-Challenge-TrainingData/BraTS-GLI-01341-000/BraTS-GLI-01341-000-t1n.nii.gz,../../DataSet/ASNR-MICCAI-BraTS2023-GLI-Challenge-TrainingData/BraTS-GLI-01341-000/BraTS-GLI-01341-000-seg.nii.gz,71,118,96,59,99,60,127,79,108,40,67,29
00160-000,../../DataSet/ASNR-MICCAI-BraTS2023-GLI-Challenge-TrainingData/BraTS-GLI-00160-000/BraTS-GLI-00160-000-t1c.nii.gz,../../DataSet/ASNR-MICCAI-BraTS2023-GLI-Challenge-TrainingData/BraTS-GLI-00160-000/BraTS-GLI-00160-000-t2w.nii.gz,../../DataSet/ASNR-MICCAI-BraTS2023-GLI-Challenge-TrainingData/BraTS-GLI-00160-000/BraTS-GLI-00160-000-t2f.nii.gz,../../DataSet/ASNR-MICCAI-BraTS2023-GLI-Challenge-TrainingData/BraTS-GLI-00160-000/BraTS-GLI-00160-000-t1n.nii.gz,../../DataSet/ASNR-MICCAI-BraTS2023-GLI-Challenge-TrainingData/BraTS-GLI-00160-000/BraTS-GLI-00160-000-seg.nii.gz,79,143,77,54,142,103,189,45,114,88,86,69
01109-000,../../DataSet/ASNR-MICCAI-BraTS2023-GLI-Challenge-TrainingData/BraTS-GLI-01109-000/BraTS-GLI-01109-000-t1c.nii.gz,../../DataSet/ASNR-MICCAI-BraTS2023-GLI-Challenge-TrainingData/BraTS-GLI-01109-000/BraTS-GLI-01109-000-t2w.nii.gz,../../DataSet/ASNR-MICCAI-BraTS2023-GLI-Challenge-TrainingData/BraTS-GLI-01109-000/BraTS-GLI-01109-000-t2f.nii.gz,../../DataSet/ASNR-MICCAI-BraTS2023-GLI-Challenge-TrainingData/BraTS-GLI-01109-000/BraTS-GLI-01109-000-t1n.nii.gz,../../DataSet/ASNR-MICCAI-BraTS2023-GLI-Challenge-TrainingData/BraTS-GLI-01109-000/BraTS-GLI-01109-000-seg.nii.gz,118,160,86,83,154,135,193,65,114,71,58,49
00328-000,../../DataSet/ASNR-MICCAI-BraTS2023-GLI-Challenge-TrainingData/BraTS-GLI-00328-000/BraTS-GLI-00328-000-t1c.nii.gz,../../DataSet/ASNR-MICCAI-BraTS2023-GLI-Challenge-TrainingData/BraTS-GLI-00328-000/BraTS-GLI-00328-000-t2w.nii.gz,../../DataSet/ASNR-MICCAI-BraTS2023-GLI-Challenge-TrainingData/BraTS-GLI-00328-000/BraTS-GLI-00328-000-t2f.nii.gz,../../DataSet/ASNR-MICCAI-BraTS2023-GLI-Challenge-TrainingData/BraTS-GLI-00328-000/BraTS-GLI-00328-000-t1n.nii.gz,../../DataSet/ASNR-MICCAI-BraTS2023-GLI-Challenge-TrainingData/BraTS-GLI-00328-000/BraTS-GLI-00328-000-seg.nii.gz,81,163,58,52,105,116,201,37,92,53,85,55
01051-000,../../DataSet/ASNR-MICCAI-BraTS2023-GLI-Challenge-TrainingData/BraTS-GLI-01051-000/BraTS-GLI-01051-000-t1c.nii.gz,../../DataSet/ASNR-MICCAI-BraTS2023-GLI-Challenge-TrainingData/BraTS-GLI-01051-000/BraTS-GLI-01051-000-t2w.nii.gz,../../DataSet/ASNR-MICCAI-BraTS2023-GLI-Challenge-TrainingData/BraTS-GLI-01051-000/BraTS-GLI-01051-000-t2f.nii.gz,../../DataSet/ASNR-MICCAI-BraTS2023-GLI-Challenge-TrainingData/BraTS-GLI-01051-000/BraTS-GLI-01051-000-t1n.nii.gz,../../DataSet/ASNR-MICCAI-BraTS2023-GLI-Challenge-TrainingData/BraTS-GLI-01051-000/BraTS-GLI-01051-000-seg.nii.gz,81,110,72,54,118,76,157,33,100,64,81,67
01397-000,../../DataSet/ASNR-MICCAI-BraTS2023-GLI-Challenge-TrainingData/BraTS-GLI-01397-000/BraTS-GLI-01397-000-t1c.nii.gz,../../DataSet/ASNR-MICCAI-BraTS2023-GLI-Challenge-TrainingData/BraTS-GLI-01397-000/BraTS-GLI-01397-000-t2w.nii.gz,../../DataSet/ASNR-MICCAI-BraTS2023-GLI-Challenge-TrainingData/BraTS-GLI-01397-000/BraTS-GLI-01397-000-t2f.nii.gz,../../DataSet/ASNR-MICCAI-BraTS2023-GLI-Challenge-TrainingData/BraTS-GLI-01397-000/BraTS-GLI-01397-000-t1n.nii.gz,../../DataSet/ASNR-MICCAI-BraTS2023-GLI-Challenge-TrainingData/BraTS-GLI-01397-000/BraTS-GLI-01397-000-seg.nii.gz,83,147,51,62,109,113,184,29,75,47,71,46
01346-000,../../DataSet/ASNR-MICCAI-BraTS2023-GLI-Challenge-TrainingData/BraTS-GLI-01346-000/BraTS-GLI-01346-000-t1c.nii.gz,../../DataSet/ASNR-MICCAI-BraTS2023-GLI-Challenge-TrainingData/BraTS-GLI-01346-000/BraTS-GLI-01346-000-t2w.nii.gz,../../DataSet/ASNR-MICCAI-BraTS2023-GLI-Challenge-TrainingData/BraTS-GLI-01346-000/BraTS-GLI-01346-000-t2f.nii.gz,../../DataSet/ASNR-MICCAI-BraTS2023-GLI-Challenge-TrainingData/BraTS-GLI-01346-000/BraTS-GLI-01346-000-t1n.nii.gz,../../DataSet/ASNR-MICCAI-BraTS2023-GLI-Challenge-TrainingData/BraTS-GLI-01346-000/BraTS-GLI-01346-000-seg.nii.gz,137,87,90,97,170,41,131,56,136,73,90,80
00506-000,../../DataSet/ASNR-MICCAI-BraTS2023-GLI-Challenge-TrainingData/BraTS-GLI-00506-000/BraTS-GLI-00506-000-t1c.nii.gz,../../DataSet/ASNR-MICCAI-BraTS2023-GLI-Challenge-TrainingData/BraTS-GLI-00506-000/BraTS-GLI-00506-000-t2w.nii.gz,../../DataSet/ASNR-MICCAI-BraTS2023-GLI-Challenge-TrainingData/BraTS-GLI-00506-000/BraTS-GLI-00506-000-t2f.nii.gz,../../DataSet/ASNR-MICCAI-BraTS2023-GLI-Challenge-TrainingData/BraTS-GLI-00506-000/BraTS-GLI-00506-000-t1n.nii.gz,../../DataSet/ASNR-MICCAI-BraTS2023-GLI-Challenge-TrainingData/BraTS-GLI-00506-000/BraTS-GLI-00506-000-seg.nii.gz,107,153,105,84,129,121,193,75,141,45,72,66
00167-000,../../DataSet/ASNR-MICCAI-BraTS2023-GLI-Challenge-TrainingData/BraTS-GLI-00167-000/BraTS-GLI-00167-000-t1c.nii.gz,../../DataSet/ASNR-MICCAI-BraTS2023-GLI-Challenge-TrainingData/BraTS-GLI-00167-000/BraTS-GLI-00167-000-t2w.nii.gz,../../DataSet/ASNR-MICCAI-BraTS2023-GLI-Challenge-TrainingData/BraTS-GLI-00167-000/BraTS-GLI-00167-000-t2f.nii.gz,../../DataSet/ASNR-MICCAI-BraTS2023-GLI-Challenge-TrainingData/BraTS-GLI-00167-000/BraTS-GLI-00167-000-t1n.nii.gz,../../DataSet/ASNR-MICCAI-BraTS2023-GLI-Challenge-TrainingData/BraTS-GLI-00167-000/BraTS-GLI-00167-000-seg.nii.gz,95,173,82,69,124,136,205,58,107,55,69,49
01080-000,../../DataSet/ASNR-MICCAI-BraTS2023-GLI-Challenge-TrainingData/BraTS-GLI-01080-000/BraTS-GLI-01080-000-t1c.nii.gz,../../DataSet/ASNR-MICCAI-BraTS2023-GLI-Challenge-TrainingData/BraTS-GLI-01080-000/BraTS-GLI-01080-000-t2w.nii.gz,../../DataSet/ASNR-MICCAI-BraTS2023-GLI-Challenge-TrainingData/BraTS-GLI-01080-000/BraTS-GLI-01080-000-t2f.nii.gz,../../DataSet/ASNR-MICCAI-BraTS2023-GLI-Challenge-TrainingData/BraTS-GLI-01080-000/BraTS-GLI-01080-000-t1n.nii.gz,../../DataSet/ASNR-MICCAI-BraTS2023-GLI-Challenge-TrainingData/BraTS-GLI-01080-000/BraTS-GLI-01080-000-seg.nii.gz,160,151,67,136,185,97,192,39,107,49,95,68
00043-000,../../DataSet/ASNR-MICCAI-BraTS2023-GLI-Challenge-TrainingData/BraTS-GLI-00043-000/BraTS-GLI-00043-000-t1c.nii.gz,../../DataSet/ASNR-MICCAI-BraTS2023-GLI-Challenge-TrainingData/BraTS-GLI-00043-000/BraTS-GLI-00043-000-t2w.nii.gz,../../DataSet/ASNR-MICCAI-BraTS2023-GLI-Challenge-TrainingData/BraTS-GLI-00043-000/BraTS-GLI-00043-000-t2f.nii.gz,../../DataSet/ASNR-MICCAI-BraTS2023-GLI-Challenge-TrainingData/BraTS-GLI-00043-000/BraTS-GLI-00043-000-t1n.nii.gz,../../DataSet/ASNR-MICCAI-BraTS2023-GLI-Challenge-TrainingData/BraTS-GLI-00043-000/BraTS-GLI-00043-000-seg.nii.gz,156,120,42,126,185,83,160,13,69,59,77,56
00735-000,../../DataSet/ASNR-MICCAI-BraTS2023-GLI-Challenge-TrainingData/BraTS-GLI-00735-000/BraTS-GLI-00735-000-t1c.nii.gz,../../DataSet/ASNR-MICCAI-BraTS2023-GLI-Challenge-TrainingData/BraTS-GLI-00735-000/BraTS-GLI-00735-000-t2w.nii.gz,../../DataSet/ASNR-MICCAI-BraTS2023-GLI-Challenge-TrainingData/BraTS-GLI-00735-000/BraTS-GLI-00735-000-t2f.nii.gz,../../DataSet/ASNR-MICCAI-BraTS2023-GLI-Challenge-TrainingData/BraTS-GLI-00735-000/BraTS-GLI-00735-000-t1n.nii.gz,../../DataSet/ASNR-MICCAI-BraTS2023-GLI-Challenge-TrainingData/BraTS-GLI-00735-000/BraTS-GLI-00735-000-seg.nii.gz,154,102,58,129,173,78,136,33,84,44,58,51
00048-001,../../DataSet/ASNR-MICCAI-BraTS2023-GLI-Challenge-TrainingData/BraTS-GLI-00048-001/BraTS-GLI-00048-001-t1c.nii.gz,../../DataSet/ASNR-MICCAI-BraTS2023-GLI-Challenge-TrainingData/BraTS-GLI-00048-001/BraTS-GLI-00048-001-t2w.nii.gz,../../DataSet/ASNR-MICCAI-BraTS2023-GLI-Challenge-TrainingData/BraTS-GLI-00048-001/BraTS-GLI-00048-001-t2f.nii.gz,../../DataSet/ASNR-MICCAI-BraTS2023-GLI-Challenge-TrainingData/BraTS-GLI-00048-001/BraTS-GLI-00048-001-t1n.nii.gz,../../DataSet/ASNR-MICCAI-BraTS2023-GLI-Challenge-TrainingData/BraTS-GLI-00048-001/BraTS-GLI-00048-001-seg.nii.gz,148,185,42,136,166,155,211,25,61,30,56,36
00099-001,../../DataSet/ASNR-MICCAI-BraTS2023-GLI-Challenge-TrainingData/BraTS-GLI-00099-001/BraTS-GLI-00099-001-t1c.nii.gz,../../DataSet/ASNR-MICCAI-BraTS2023-GLI-Challenge-TrainingData/BraTS-GLI-00099-001/BraTS-GLI-00099-001-t2w.nii.gz,../../DataSet/ASNR-MICCAI-BraTS2023-GLI-Challenge-TrainingData/BraTS-GLI-00099-001/BraTS-GLI-00099-001-t2f.nii.gz,../../DataSet/ASNR-MICCAI-BraTS2023-GLI-Challenge-TrainingData/BraTS-GLI-00099-001/BraTS-GLI-00099-001-t1n.nii.gz,../../DataSet/ASNR-MICCAI-BraTS2023-GLI-Challenge-TrainingData/BraTS-GLI-00099-001/BraTS-GLI-00099-001-seg.nii.gz,98,163,95,67,152,132,197,52,134,85,65,82
01357-000,../../DataSet/ASNR-MICCAI-BraTS2023-GLI-Challenge-TrainingData/BraTS-GLI-01357-000/BraTS-GLI-01357-000-t1c.nii.gz,../../DataSet/ASNR-MICCAI-BraTS2023-GLI-Challenge-TrainingData/BraTS-GLI-01357-000/BraTS-GLI-01357-000-t2w.nii.gz,../../DataSet/ASNR-MICCAI-BraTS2023-GLI-Challenge-TrainingData/BraTS-GLI-01357-000/BraTS-GLI-01357-000-t2f.nii.gz,../../DataSet/ASNR-MICCAI-BraTS2023-GLI-Challenge-TrainingData/BraTS-GLI-01357-000/BraTS-GLI-01357-000-t1n.nii.gz,../../DataSet/ASNR-MICCAI-BraTS2023-GLI-Challenge-TrainingData/BraTS-GLI-01357-000/BraTS-GLI-01357-000-seg.nii.gz,90,166,85,66,126,133,203,51,124,60,70,73
00517-000,../../DataSet/ASNR-MICCAI-BraTS2023-GLI-Challenge-TrainingData/BraTS-GLI-00517-000/BraTS-GLI-00517-000-t1c.nii.gz,../../DataSet/ASNR-MICCAI-BraTS2023-GLI-Challenge-TrainingData/BraTS-GLI-00517-000/BraTS-GLI-00517-000-t2w.nii.gz,../../DataSet/ASNR-MICCAI-BraTS2023-GLI-Challenge-TrainingData/BraTS-GLI-00517-000/BraTS-GLI-00517-000-t2f.nii.gz,../../DataSet/ASNR-MICCAI-BraTS2023-GLI-Challenge-TrainingData/BraTS-GLI-00517-000/BraTS-GLI-00517-000-t1n.nii.gz,../../DataSet/ASNR-MICCAI-BraTS2023-GLI-Challenge-TrainingData/BraTS-GLI-00517-000/BraTS-GLI-00517-000-seg.nii.gz,95,153,86,60,142,108,196,53,125,82,88,72
00495-001,../../DataSet/ASNR-MICCAI-BraTS2023-GLI-Challenge-TrainingData/BraTS-GLI-00495-001/BraTS-GLI-00495-001-t1c.nii.gz,../../DataSet/ASNR-MICCAI-BraTS2023-GLI-Challenge-TrainingData/BraTS-GLI-00495-001/BraTS-GLI-00495-001-t2w.nii.gz,../../DataSet/ASNR-MICCAI-BraTS2023-GLI-Challenge-TrainingData/BraTS-GLI-00495-001/BraTS-GLI-00495-001-t2f.nii.gz,../../DataSet/ASNR-MICCAI-BraTS2023-GLI-Challenge-TrainingData/BraTS-GLI-00495-001/BraTS-GLI-00495-001-t1n.nii.gz,../../DataSet/ASNR-MICCAI-BraTS2023-GLI-Challenge-TrainingData/BraTS-GLI-00495-001/BraTS-GLI-00495-001-seg.nii.gz,97,172,91,72,122,139,209,61,128,50,70,67
00753-001,../../DataSet/ASNR-MICCAI-BraTS2023-GLI-Challenge-TrainingData/BraTS-GLI-00753-001/BraTS-GLI-00753-001-t1c.nii.gz,../../DataSet/ASNR-MICCAI-BraTS2023-GLI-Challenge-TrainingData/BraTS-GLI-00753-001/BraTS-GLI-00753-001-t2w.nii.gz,../../DataSet/ASNR-MICCAI-BraTS2023-GLI-Challenge-TrainingData/BraTS-GLI-00753-001/BraTS-GLI-00753-001-t2f.nii.gz,../../DataSet/ASNR-MICCAI-BraTS2023-GLI-Challenge-TrainingData/BraTS-GLI-00753-001/BraTS-GLI-00753-001-t1n.nii.gz,../../DataSet/ASNR-MICCAI-BraTS2023-GLI-Challenge-TrainingData/BraTS-GLI-00753-001/BraTS-GLI-00753-001-seg.nii.gz,97,153,47,85,111,136,172,42,52,26,36,10
01091-000,../../DataSet/ASNR-MICCAI-BraTS2023-GLI-Challenge-TrainingData/BraTS-GLI-01091-000/BraTS-GLI-01091-000-t1c.nii.gz,../../DataSet/ASNR-MICCAI-BraTS2023-GLI-Challenge-TrainingData/BraTS-GLI-01091-000/BraTS-GLI-01091-000-t2w.nii.gz,../../DataSet/ASNR-MICCAI-BraTS2023-GLI-Challenge-TrainingData/BraTS-GLI-01091-000/BraTS-GLI-01091-000-t2f.nii.gz,../../DataSet/ASNR-MICCAI-BraTS2023-GLI-Challenge-TrainingData/BraTS-GLI-01091-000/BraTS-GLI-01091-000-t1n.nii.gz,../../DataSet/ASNR-MICCAI-BraTS2023-GLI-Challenge-TrainingData/BraTS-GLI-01091-000/BraTS-GLI-01091-000-seg.nii.gz,112,97,116,101,121,74,121,93,137,20,47,44
01040-000,../../DataSet/ASNR-MICCAI-BraTS2023-GLI-Challenge-TrainingData/BraTS-GLI-01040-000/BraTS-GLI-01040-000-t1c.nii.gz,../../DataSet/ASNR-MICCAI-BraTS2023-GLI-Challenge-TrainingData/BraTS-GLI-01040-000/BraTS-GLI-01040-000-t2w.nii.gz,../../DataSet/ASNR-MICCAI-BraTS2023-GLI-Challenge-TrainingData/BraTS-GLI-01040-000/BraTS-GLI-01040-000-t2f.nii.gz,../../DataSet/ASNR-MICCAI-BraTS2023-GLI-Challenge-TrainingData/BraTS-GLI-01040-000/BraTS-GLI-01040-000-t1n.nii.gz,../../DataSet/ASNR-MICCAI-BraTS2023-GLI-Challenge-TrainingData/BraTS-GLI-01040-000/BraTS-GLI-01040-000-seg.nii.gz,87,167,80,57,120,112,204,44,120,63,92,76
01421-000,../../DataSet/ASNR-MICCAI-BraTS2023-GLI-Challenge-TrainingData/BraTS-GLI-01421-000/BraTS-GLI-01421-000-t1c.nii.gz,../../DataSet/ASNR-MICCAI-BraTS2023-GLI-Challenge-TrainingData/BraTS-GLI-01421-000/BraTS-GLI-01421-000-t2w.nii.gz,../../DataSet/ASNR-MICCAI-BraTS2023-GLI-Challenge-TrainingData/BraTS-GLI-01421-000/BraTS-GLI-01421-000-t2f.nii.gz,../../DataSet/ASNR-MICCAI-BraTS2023-GLI-Challenge-TrainingData/BraTS-GLI-01421-000/BraTS-GLI-01421-000-t1n.nii.gz,../../DataSet/ASNR-MICCAI-BraTS2023-GLI-Challenge-TrainingData/BraTS-GLI-01421-000/BraTS-GLI-01421-000-seg.nii.gz,139,118,106,109,172,71,165,75,140,63,94,65
01118-000,../../DataSet/ASNR-MICCAI-BraTS2023-GLI-Challenge-TrainingData/BraTS-GLI-01118-000/BraTS-GLI-01118-000-t1c.nii.gz,../../DataSet/ASNR-MICCAI-BraTS2023-GLI-Challenge-TrainingData/BraTS-GLI-01118-000/BraTS-GLI-01118-000-t2w.nii.gz,../../DataSet/ASNR-MICCAI-BraTS2023-GLI-Challenge-TrainingData/BraTS-GLI-01118-000/BraTS-GLI-01118-000-t2f.nii.gz,../../DataSet/ASNR-MICCAI-BraTS2023-GLI-Challenge-TrainingData/BraTS-GLI-01118-000/BraTS-GLI-01118-000-t1n.nii.gz,../../DataSet/ASNR-MICCAI-BraTS2023-GLI-Challenge-TrainingData/BraTS-GLI-01118-000/BraTS-GLI-01118-000-seg.nii.gz,163,135,63,138,185,103,169,39,106,47,66,67
00758-000,../../DataSet/ASNR-MICCAI-BraTS2023-GLI-Challenge-TrainingData/BraTS-GLI-00758-000/BraTS-GLI-00758-000-t1c.nii.gz,../../DataSet/ASNR-MICCAI-BraTS2023-GLI-Challenge-TrainingData/BraTS-GLI-00758-000/BraTS-GLI-00758-000-t2w.nii.gz,../../DataSet/ASNR-MICCAI-BraTS2023-GLI-Challenge-TrainingData/BraTS-GLI-00758-000/BraTS-GLI-00758-000-t2f.nii.gz,../../DataSet/ASNR-MICCAI-BraTS2023-GLI-Challenge-TrainingData/BraTS-GLI-00758-000/BraTS-GLI-00758-000-t1n.nii.gz,../../DataSet/ASNR-MICCAI-BraTS2023-GLI-Challenge-TrainingData/BraTS-GLI-00758-000/BraTS-GLI-00758-000-seg.nii.gz,149,140,59,131,171,112,174,42,77,40,62,35
00339-000,../../DataSet/ASNR-MICCAI-BraTS2023-GLI-Challenge-TrainingData/BraTS-GLI-00339-000/BraTS-GLI-00339-000-t1c.nii.gz,../../DataSet/ASNR-MICCAI-BraTS2023-GLI-Challenge-TrainingData/BraTS-GLI-00339-000/BraTS-GLI-00339-000-t2w.nii.gz,../../DataSet/ASNR-MICCAI-BraTS2023-GLI-Challenge-TrainingData/BraTS-GLI-00339-000/BraTS-GLI-00339-000-t2f.nii.gz,../../DataSet/ASNR-MICCAI-BraTS2023-GLI-Challenge-TrainingData/BraTS-GLI-00339-000/BraTS-GLI-00339-000-t1n.nii.gz,../../DataSet/ASNR-MICCAI-BraTS2023-GLI-Challenge-TrainingData/BraTS-GLI-00339-000/BraTS-GLI-00339-000-seg.nii.gz,139,152,107,118,172,117,193,72,140,54,76,68
00789-000,../../DataSet/ASNR-MICCAI-BraTS2023-GLI-Challenge-TrainingData/BraTS-GLI-00789-000/BraTS-GLI-00789-000-t1c.nii.gz,../../DataSet/ASNR-MICCAI-BraTS2023-GLI-Challenge-TrainingData/BraTS-GLI-00789-000/BraTS-GLI-00789-000-t2w.nii.gz,../../DataSet/ASNR-MICCAI-BraTS2023-GLI-Challenge-TrainingData/BraTS-GLI-00789-000/BraTS-GLI-00789-000-t2f.nii.gz,../../DataSet/ASNR-MICCAI-BraTS2023-GLI-Challenge-TrainingData/BraTS-GLI-00789-000/BraTS-GLI-00789-000-t1n.nii.gz,../../DataSet/ASNR-MICCAI-BraTS2023-GLI-Challenge-TrainingData/BraTS-GLI-00789-000/BraTS-GLI-00789-000-seg.nii.gz,145,111,83,115,176,77,150,44,117,61,73,73
00088-001,../../DataSet/ASNR-MICCAI-BraTS2023-GLI-Challenge-TrainingData/BraTS-GLI-00088-001/BraTS-GLI-00088-001-t1c.nii.gz,../../DataSet/ASNR-MICCAI-BraTS2023-GLI-Challenge-TrainingData/BraTS-GLI-00088-001/BraTS-GLI-00088-001-t2w.nii.gz,../../DataSet/ASNR-MICCAI-BraTS2023-GLI-Challenge-TrainingData/BraTS-GLI-00088-001/BraTS-GLI-00088-001-t2f.nii.gz,../../DataSet/ASNR-MICCAI-BraTS2023-GLI-Challenge-TrainingData/BraTS-GLI-00088-001/BraTS-GLI-00088-001-t1n.nii.gz,../../DataSet/ASNR-MICCAI-BraTS2023-GLI-Challenge-TrainingData/BraTS-GLI-00088-001/BraTS-GLI-00088-001-seg.nii.gz,98,165,82,68,163,110,203,54,121,95,93,67
00059-001,../../DataSet/ASNR-MICCAI-BraTS2023-GLI-Challenge-TrainingData/BraTS-GLI-00059-001/BraTS-GLI-00059-001-t1c.nii.gz,../../DataSet/ASNR-MICCAI-BraTS2023-GLI-Challenge-TrainingData/BraTS-GLI-00059-001/BraTS-GLI-00059-001-t2w.nii.gz,../../DataSet/ASNR-MICCAI-BraTS2023-GLI-Challenge-TrainingData/BraTS-GLI-00059-001/BraTS-GLI-00059-001-t2f.nii.gz,../../DataSet/ASNR-MICCAI-BraTS2023-GLI-Challenge-TrainingData/BraTS-GLI-00059-001/BraTS-GLI-00059-001-t1n.nii.gz,../../DataSet/ASNR-MICCAI-BraTS2023-GLI-Challenge-TrainingData/BraTS-GLI-00059-001/BraTS-GLI-00059-001-seg.nii.gz,145,102,61,116,166,79,133,30,96,50,54,66
01164-000,../../DataSet/ASNR-MICCAI-BraTS2023-GLI-Challenge-TrainingData/BraTS-GLI-01164-000/BraTS-GLI-01164-000-t1c.nii.gz,../../DataSet/ASNR-MICCAI-BraTS2023-GLI-Challenge-TrainingData/BraTS-GLI-01164-000/BraTS-GLI-01164-000-t2w.nii.gz,../../DataSet/ASNR-MICCAI-BraTS2023-GLI-Challenge-TrainingData/BraTS-GLI-01164-000/BraTS-GLI-01164-000-t2f.nii.gz,../../DataSet/ASNR-MICCAI-BraTS2023-GLI-Challenge-TrainingData/BraTS-GLI-01164-000/BraTS-GLI-01164-000-t1n.nii.gz,../../DataSet/ASNR-MICCAI-BraTS2023-GLI-Challenge-TrainingData/BraTS-GLI-01164-000/BraTS-GLI-01164-000-seg.nii.gz,129,99,87,94,167,73,133,62,119,73,60,57
00724-000,../../DataSet/ASNR-MICCAI-BraTS2023-GLI-Challenge-TrainingData/BraTS-GLI-00724-000/BraTS-GLI-00724-000-t1c.nii.gz,../../DataSet/ASNR-MICCAI-BraTS2023-GLI-Challenge-TrainingData/BraTS-GLI-00724-000/BraTS-GLI-00724-000-t2w.nii.gz,../../DataSet/ASNR-MICCAI-BraTS2023-GLI-Challenge-TrainingData/BraTS-GLI-00724-000/BraTS-GLI-00724-000-t2f.nii.gz,../../DataSet/ASNR-MICCAI-BraTS2023-GLI-Challenge-TrainingData/BraTS-GLI-00724-000/BraTS-GLI-00724-000-t1n.nii.gz,../../DataSet/ASNR-MICCAI-BraTS2023-GLI-Challenge-TrainingData/BraTS-GLI-00724-000/BraTS-GLI-00724-000-seg.nii.gz,100,82,92,68,131,41,124,61,130,63,83,69
01505-000,../../DataSet/ASNR-MICCAI-BraTS2023-GLI-Challenge-TrainingData/BraTS-GLI-01505-000/BraTS-GLI-01505-000-t1c.nii.gz,../../DataSet/ASNR-MICCAI-BraTS2023-GLI-Challenge-TrainingData/BraTS-GLI-01505-000/BraTS-GLI-01505-000-t2w.nii.gz,../../DataSet/ASNR-MICCAI-BraTS2023-GLI-Challenge-TrainingData/BraTS-GLI-01505-000/BraTS-GLI-01505-000-t2f.nii.gz,../../DataSet/ASNR-MICCAI-BraTS2023-GLI-Challenge-TrainingData/BraTS-GLI-01505-000/BraTS-GLI-01505-000-t1n.nii.gz,../../DataSet/ASNR-MICCAI-BraTS2023-GLI-Challenge-TrainingData/BraTS-GLI-01505-000/BraTS-GLI-01505-000-seg.nii.gz,137,92,101,106,172,50,134,62,135,66,84,73
01273-000,../../DataSet/ASNR-MICCAI-BraTS2023-GLI-Challenge-TrainingData/BraTS-GLI-01273-000/BraTS-GLI-01273-000-t1c.nii.gz,../../DataSet/ASNR-MICCAI-BraTS2023-GLI-Challenge-TrainingData/BraTS-GLI-01273-000/BraTS-GLI-01273-000-t2w.nii.gz,../../DataSet/ASNR-MICCAI-BraTS2023-GLI-Challenge-TrainingData/BraTS-GLI-01273-000/BraTS-GLI-01273-000-t2f.nii.gz,../../DataSet/ASNR-MICCAI-BraTS2023-GLI-Challenge-TrainingData/BraTS-GLI-01273-000/BraTS-GLI-01273-000-t1n.nii.gz,../../DataSet/ASNR-MICCAI-BraTS2023-GLI-Challenge-TrainingData/BraTS-GLI-01273-000/BraTS-GLI-01273-000-seg.nii.gz,88,125,116,77,101,113,139,103,131,24,26,28
00433-000,../../DataSet/ASNR-MICCAI-BraTS2023-GLI-Challenge-TrainingData/BraTS-GLI-00433-000/BraTS-GLI-00433-000-t1c.nii.gz,../../DataSet/ASNR-MICCAI-BraTS2023-GLI-Challenge-TrainingData/BraTS-GLI-00433-000/BraTS-GLI-00433-000-t2w.nii.gz,../../DataSet/ASNR-MICCAI-BraTS2023-GLI-Challenge-TrainingData/BraTS-GLI-00433-000/BraTS-GLI-00433-000-t2f.nii.gz,../../DataSet/ASNR-MICCAI-BraTS2023-GLI-Challenge-TrainingData/BraTS-GLI-00433-000/BraTS-GLI-00433-000-t1n.nii.gz,../../DataSet/ASNR-MICCAI-BraTS2023-GLI-Challenge-TrainingData/BraTS-GLI-00433-000/BraTS-GLI-00433-000-seg.nii.gz,110,118,103,89,130,91,145,86,125,41,54,39
00084-000,../../DataSet/ASNR-MICCAI-BraTS2023-GLI-Challenge-TrainingData/BraTS-GLI-00084-000/BraTS-GLI-00084-000-t1c.nii.gz,../../DataSet/ASNR-MICCAI-BraTS2023-GLI-Challenge-TrainingData/BraTS-GLI-00084-000/BraTS-GLI-00084-000-t2w.nii.gz,../../DataSet/ASNR-MICCAI-BraTS2023-GLI-Challenge-TrainingData/BraTS-GLI-00084-000/BraTS-GLI-00084-000-t2f.nii.gz,../../DataSet/ASNR-MICCAI-BraTS2023-GLI-Challenge-TrainingData/BraTS-GLI-00084-000/BraTS-GLI-00084-000-t1n.nii.gz,../../DataSet/ASNR-MICCAI-BraTS2023-GLI-Challenge-TrainingData/BraTS-GLI-00084-000/BraTS-GLI-00084-000-seg.nii.gz,77,130,87,57,102,88,172,58,113,45,84,55
00723-000,../../DataSet/ASNR-MICCAI-BraTS2023-GLI-Challenge-TrainingData/BraTS-GLI-00723-000/BraTS-GLI-00723-000-t1c.nii.gz,../../DataSet/ASNR-MICCAI-BraTS2023-GLI-Challenge-TrainingData/BraTS-GLI-00723-000/BraTS-GLI-00723-000-t2w.nii.gz,../../DataSet/ASNR-MICCAI-BraTS2023-GLI-Challenge-TrainingData/BraTS-GLI-00723-000/BraTS-GLI-00723-000-t2f.nii.gz,../../DataSet/ASNR-MICCAI-BraTS2023-GLI-Challenge-TrainingData/BraTS-GLI-00723-000/BraTS-GLI-00723-000-t1n.nii.gz,../../DataSet/ASNR-MICCAI-BraTS2023-GLI-Challenge-TrainingData/BraTS-GLI-00723-000/BraTS-GLI-00723-000-seg.nii.gz,158,128,64,129,185,94,165,35,95,56,71,60
01163-000,../../DataSet/ASNR-MICCAI-BraTS2023-GLI-Challenge-TrainingData/BraTS-GLI-01163-000/BraTS-GLI-01163-000-t1c.nii.gz,../../DataSet/ASNR-MICCAI-BraTS2023-GLI-Challenge-TrainingData/BraTS-GLI-01163-000/BraTS-GLI-01163-000-t2w.nii.gz,../../DataSet/ASNR-MICCAI-BraTS2023-GLI-Challenge-TrainingData/BraTS-GLI-01163-000/BraTS-GLI-01163-000-t2f.nii.gz,../../DataSet/ASNR-MICCAI-BraTS2023-GLI-Challenge-TrainingData/BraTS-GLI-01163-000/BraTS-GLI-01163-000-t1n.nii.gz,../../DataSet/ASNR-MICCAI-BraTS2023-GLI-Challenge-TrainingData/BraTS-GLI-01163-000/BraTS-GLI-01163-000-seg.nii.gz,135,120,77,105,159,75,157,50,116,54,82,66
01502-000,../../DataSet/ASNR-MICCAI-BraTS2023-GLI-Challenge-TrainingData/BraTS-GLI-01502-000/BraTS-GLI-01502-000-t1c.nii.gz,../../DataSet/ASNR-MICCAI-BraTS2023-GLI-Challenge-TrainingData/BraTS-GLI-01502-000/BraTS-GLI-01502-000-t2w.nii.gz,../../DataSet/ASNR-MICCAI-BraTS2023-GLI-Challenge-TrainingData/BraTS-GLI-01502-000/BraTS-GLI-01502-000-t2f.nii.gz,../../DataSet/ASNR-MICCAI-BraTS2023-GLI-Challenge-TrainingData/BraTS-GLI-01502-000/BraTS-GLI-01502-000-t1n.nii.gz,../../DataSet/ASNR-MICCAI-BraTS2023-GLI-Challenge-TrainingData/BraTS-GLI-01502-000/BraTS-GLI-01502-000-seg.nii.gz,144,173,93,120,181,131,207,55,131,61,76,76
01274-000,../../DataSet/ASNR-MICCAI-BraTS2023-GLI-Challenge-TrainingData/BraTS-GLI-01274-000/BraTS-GLI-01274-000-t1c.nii.gz,../../DataSet/ASNR-MICCAI-BraTS2023-GLI-Challenge-TrainingData/BraTS-GLI-01274-000/BraTS-GLI-01274-000-t2w.nii.gz,../../DataSet/ASNR-MICCAI-BraTS2023-GLI-Challenge-TrainingData/BraTS-GLI-01274-000/BraTS-GLI-01274-000-t2f.nii.gz,../../DataSet/ASNR-MICCAI-BraTS2023-GLI-Challenge-TrainingData/BraTS-GLI-01274-000/BraTS-GLI-01274-000-t1n.nii.gz,../../DataSet/ASNR-MICCAI-BraTS2023-GLI-Challenge-TrainingData/BraTS-GLI-01274-000/BraTS-GLI-01274-000-seg.nii.gz,92,165,64,62,118,136,203,45,87,56,67,42
01350-000,../../DataSet/ASNR-MICCAI-BraTS2023-GLI-Challenge-TrainingData/BraTS-GLI-01350-000/BraTS-GLI-01350-000-t1c.nii.gz,../../DataSet/ASNR-MICCAI-BraTS2023-GLI-Challenge-TrainingData/BraTS-GLI-01350-000/BraTS-GLI-01350-000-t2w.nii.gz,../../DataSet/ASNR-MICCAI-BraTS2023-GLI-Challenge-TrainingData/BraTS-GLI-01350-000/BraTS-GLI-01350-000-t2f.nii.gz,../../DataSet/ASNR-MICCAI-BraTS2023-GLI-Challenge-TrainingData/BraTS-GLI-01350-000/BraTS-GLI-01350-000-t1n.nii.gz,../../DataSet/ASNR-MICCAI-BraTS2023-GLI-Challenge-TrainingData/BraTS-GLI-01350-000/BraTS-GLI-01350-000-seg.nii.gz,165,113,57,147,182,86,142,36,81,35,56,45
01096-000,../../DataSet/ASNR-MICCAI-BraTS2023-GLI-Challenge-TrainingData/BraTS-GLI-01096-000/BraTS-GLI-01096-000-t1c.nii.gz,../../DataSet/ASNR-MICCAI-BraTS2023-GLI-Challenge-TrainingData/BraTS-GLI-01096-000/BraTS-GLI-01096-000-t2w.nii.gz,../../DataSet/ASNR-MICCAI-BraTS2023-GLI-Challenge-TrainingData/BraTS-GLI-01096-000/BraTS-GLI-01096-000-t2f.nii.gz,../../DataSet/ASNR-MICCAI-BraTS2023-GLI-Challenge-TrainingData/BraTS-GLI-01096-000/BraTS-GLI-01096-000-t1n.nii.gz,../../DataSet/ASNR-MICCAI-BraTS2023-GLI-Challenge-TrainingData/BraTS-GLI-01096-000/BraTS-GLI-01096-000-seg.nii.gz,144,168,89,119,177,132,206,47,134,58,74,87
00171-000,../../DataSet/ASNR-MICCAI-BraTS2023-GLI-Challenge-TrainingData/BraTS-GLI-00171-000/BraTS-GLI-00171-000-t1c.nii.gz,../../DataSet/ASNR-MICCAI-BraTS2023-GLI-Challenge-TrainingData/BraTS-GLI-00171-000/BraTS-GLI-00171-000-t2w.nii.gz,../../DataSet/ASNR-MICCAI-BraTS2023-GLI-Challenge-TrainingData/BraTS-GLI-00171-000/BraTS-GLI-00171-000-t2f.nii.gz,../../DataSet/ASNR-MICCAI-BraTS2023-GLI-Challenge-TrainingData/BraTS-GLI-00171-000/BraTS-GLI-00171-000-t1n.nii.gz,../../DataSet/ASNR-MICCAI-BraTS2023-GLI-Challenge-TrainingData/BraTS-GLI-00171-000/BraTS-GLI-00171-000-seg.nii.gz,154,114,47,130,186,80,161,24,71,56,81,47
01426-000,../../DataSet/ASNR-MICCAI-BraTS2023-GLI-Challenge-TrainingData/BraTS-GLI-01426-000/BraTS-GLI-01426-000-t1c.nii.gz,../../DataSet/ASNR-MICCAI-BraTS2023-GLI-Challenge-TrainingData/BraTS-GLI-01426-000/BraTS-GLI-01426-000-t2w.nii.gz,../../DataSet/ASNR-MICCAI-BraTS2023-GLI-Challenge-TrainingData/BraTS-GLI-01426-000/BraTS-GLI-01426-000-t2f.nii.gz,../../DataSet/ASNR-MICCAI-BraTS2023-GLI-Challenge-TrainingData/BraTS-GLI-01426-000/BraTS-GLI-01426-000-t1n.nii.gz,../../DataSet/ASNR-MICCAI-BraTS2023-GLI-Challenge-TrainingData/BraTS-GLI-01426-000/BraTS-GLI-01426-000-seg.nii.gz,161,121,61,134,189,85,164,34,90,55,79,56
01381-000,../../DataSet/ASNR-MICCAI-BraTS2023-GLI-Challenge-TrainingData/BraTS-GLI-01381-000/BraTS-GLI-01381-000-t1c.nii.gz,../../DataSet/ASNR-MICCAI-BraTS2023-GLI-Challenge-TrainingData/BraTS-GLI-01381-000/BraTS-GLI-01381-000-t2w.nii.gz,../../DataSet/ASNR-MICCAI-BraTS2023-GLI-Challenge-TrainingData/BraTS-GLI-01381-000/BraTS-GLI-01381-000-t2f.nii.gz,../../DataSet/ASNR-MICCAI-BraTS2023-GLI-Challenge-TrainingData/BraTS-GLI-01381-000/BraTS-GLI-01381-000-t1n.nii.gz,../../DataSet/ASNR-MICCAI-BraTS2023-GLI-Challenge-TrainingData/BraTS-GLI-01381-000/BraTS-GLI-01381-000-seg.nii.gz,80,145,94,53,109,104,185,64,126,56,81,62
00266-000,../../DataSet/ASNR-MICCAI-BraTS2023-GLI-Challenge-TrainingData/BraTS-GLI-00266-000/BraTS-GLI-00266-000-t1c.nii.gz,../../DataSet/ASNR-MICCAI-BraTS2023-GLI-Challenge-TrainingData/BraTS-GLI-00266-000/BraTS-GLI-00266-000-t2w.nii.gz,../../DataSet/ASNR-MICCAI-BraTS2023-GLI-Challenge-TrainingData/BraTS-GLI-00266-000/BraTS-GLI-00266-000-t2f.nii.gz,../../DataSet/ASNR-MICCAI-BraTS2023-GLI-Challenge-TrainingData/BraTS-GLI-00266-000/BraTS-GLI-00266-000-t1n.nii.gz,../../DataSet/ASNR-MICCAI-BraTS2023-GLI-Challenge-TrainingData/BraTS-GLI-00266-000/BraTS-GLI-00266-000-seg.nii.gz,87,133,71,56,129,86,179,35,103,73,93,68
00499-000,../../DataSet/ASNR-MICCAI-BraTS2023-GLI-Challenge-TrainingData/BraTS-GLI-00499-000/BraTS-GLI-00499-000-t1c.nii.gz,../../DataSet/ASNR-MICCAI-BraTS2023-GLI-Challenge-TrainingData/BraTS-GLI-00499-000/BraTS-GLI-00499-000-t2w.nii.gz,../../DataSet/ASNR-MICCAI-BraTS2023-GLI-Challenge-TrainingData/BraTS-GLI-00499-000/BraTS-GLI-00499-000-t2f.nii.gz,../../DataSet/ASNR-MICCAI-BraTS2023-GLI-Challenge-TrainingData/BraTS-GLI-00499-000/BraTS-GLI-00499-000-t1n.nii.gz,../../DataSet/ASNR-MICCAI-BraTS2023-GLI-Challenge-TrainingData/BraTS-GLI-00499-000/BraTS-GLI-00499-000-seg.nii.gz,94,164,68,65,121,120,204,37,110,56,84,73
00448-000,../../DataSet/ASNR-MICCAI-BraTS2023-GLI-Challenge-TrainingData/BraTS-GLI-00448-000/BraTS-GLI-00448-000-t1c.nii.gz,../../DataSet/ASNR-MICCAI-BraTS2023-GLI-Challenge-TrainingData/BraTS-GLI-00448-000/BraTS-GLI-00448-000-t2w.nii.gz,../../DataSet/ASNR-MICCAI-BraTS2023-GLI-Challenge-TrainingData/BraTS-GLI-00448-000/BraTS-GLI-00448-000-t2f.nii.gz,../../DataSet/ASNR-MICCAI-BraTS2023-GLI-Challenge-TrainingData/BraTS-GLI-00448-000/BraTS-GLI-00448-000-t1n.nii.gz,../../DataSet/ASNR-MICCAI-BraTS2023-GLI-Challenge-TrainingData/BraTS-GLI-00448-000/BraTS-GLI-00448-000-seg.nii.gz,137,175,83,114,168,144,212,47,123,54,68,76
01208-000,../../DataSet/ASNR-MICCAI-BraTS2023-GLI-Challenge-TrainingData/BraTS-GLI-01208-000/BraTS-GLI-01208-000-t1c.nii.gz,../../DataSet/ASNR-MICCAI-BraTS2023-GLI-Challenge-TrainingData/BraTS-GLI-01208-000/BraTS-GLI-01208-000-t2w.nii.gz,../../DataSet/ASNR-MICCAI-BraTS2023-GLI-Challenge-TrainingData/BraTS-GLI-01208-000/BraTS-GLI-01208-000-t2f.nii.gz,../../DataSet/ASNR-MICCAI-BraTS2023-GLI-Challenge-TrainingData/BraTS-GLI-01208-000/BraTS-GLI-01208-000-t1n.nii.gz,../../DataSet/ASNR-MICCAI-BraTS2023-GLI-Challenge-TrainingData/BraTS-GLI-01208-000/BraTS-GLI-01208-000-seg.nii.gz,85,114,47,56,107,81,154,24,75,51,73,51
01322-000,../../DataSet/ASNR-MICCAI-BraTS2023-GLI-Challenge-TrainingData/BraTS-GLI-01322-000/BraTS-GLI-01322-000-t1c.nii.gz,../../DataSet/ASNR-MICCAI-BraTS2023-GLI-Challenge-TrainingData/BraTS-GLI-01322-000/BraTS-GLI-01322-000-t2w.nii.gz,../../DataSet/ASNR-MICCAI-BraTS2023-GLI-Challenge-TrainingData/BraTS-GLI-01322-000/BraTS-GLI-01322-000-t2f.nii.gz,../../DataSet/ASNR-MICCAI-BraTS2023-GLI-Challenge-TrainingData/BraTS-GLI-01322-000/BraTS-GLI-01322-000-t1n.nii.gz,../../DataSet/ASNR-MICCAI-BraTS2023-GLI-Challenge-TrainingData/BraTS-GLI-01322-000/BraTS-GLI-01322-000-seg.nii.gz,133,108,119,121,163,90,130,95,136,42,40,41
01485-000,../../DataSet/ASNR-MICCAI-BraTS2023-GLI-Challenge-TrainingData/BraTS-GLI-01485-000/BraTS-GLI-01485-000-t1c.nii.gz,../../DataSet/ASNR-MICCAI-BraTS2023-GLI-Challenge-TrainingData/BraTS-GLI-01485-000/BraTS-GLI-01485-000-t2w.nii.gz,../../DataSet/ASNR-MICCAI-BraTS2023-GLI-Challenge-TrainingData/BraTS-GLI-01485-000/BraTS-GLI-01485-000-t2f.nii.gz,../../DataSet/ASNR-MICCAI-BraTS2023-GLI-Challenge-TrainingData/BraTS-GLI-01485-000/BraTS-GLI-01485-000-t1n.nii.gz,../../DataSet/ASNR-MICCAI-BraTS2023-GLI-Challenge-TrainingData/BraTS-GLI-01485-000/BraTS-GLI-01485-000-seg.nii.gz,159,110,84,138,181,91,139,60,109,43,48,49
01035-000,../../DataSet/ASNR-MICCAI-BraTS2023-GLI-Challenge-TrainingData/BraTS-GLI-01035-000/BraTS-GLI-01035-000-t1c.nii.gz,../../DataSet/ASNR-MICCAI-BraTS2023-GLI-Challenge-TrainingData/BraTS-GLI-01035-000/BraTS-GLI-01035-000-t2w.nii.gz,../../DataSet/ASNR-MICCAI-BraTS2023-GLI-Challenge-TrainingData/BraTS-GLI-01035-000/BraTS-GLI-01035-000-t2f.nii.gz,../../DataSet/ASNR-MICCAI-BraTS2023-GLI-Challenge-TrainingData/BraTS-GLI-01035-000/BraTS-GLI-01035-000-t1n.nii.gz,../../DataSet/ASNR-MICCAI-BraTS2023-GLI-Challenge-TrainingData/BraTS-GLI-01035-000/BraTS-GLI-01035-000-seg.nii.gz,118,132,20,111,127,124,142,2,34,16,18,32
00675-000,../../DataSet/ASNR-MICCAI-BraTS2023-GLI-Challenge-TrainingData/BraTS-GLI-00675-000/BraTS-GLI-00675-000-t1c.nii.gz,../../DataSet/ASNR-MICCAI-BraTS2023-GLI-Challenge-TrainingData/BraTS-GLI-00675-000/BraTS-GLI-00675-000-t2w.nii.gz,../../DataSet/ASNR-MICCAI-BraTS2023-GLI-Challenge-TrainingData/BraTS-GLI-00675-000/BraTS-GLI-00675-000-t2f.nii.gz,../../DataSet/ASNR-MICCAI-BraTS2023-GLI-Challenge-TrainingData/BraTS-GLI-00675-000/BraTS-GLI-00675-000-t1n.nii.gz,../../DataSet/ASNR-MICCAI-BraTS2023-GLI-Challenge-TrainingData/BraTS-GLI-00675-000/BraTS-GLI-00675-000-seg.nii.gz,170,106,52,156,187,80,136,38,68,31,56,30
00214-000,../../DataSet/ASNR-MICCAI-BraTS2023-GLI-Challenge-TrainingData/BraTS-GLI-00214-000/BraTS-GLI-00214-000-t1c.nii.gz,../../DataSet/ASNR-MICCAI-BraTS2023-GLI-Challenge-TrainingData/BraTS-GLI-00214-000/BraTS-GLI-00214-000-t2w.nii.gz,../../DataSet/ASNR-MICCAI-BraTS2023-GLI-Challenge-TrainingData/BraTS-GLI-00214-000/BraTS-GLI-00214-000-t2f.nii.gz,../../DataSet/ASNR-MICCAI-BraTS2023-GLI-Challenge-TrainingData/BraTS-GLI-00214-000/BraTS-GLI-00214-000-t1n.nii.gz,../../DataSet/ASNR-MICCAI-BraTS2023-GLI-Challenge-TrainingData/BraTS-GLI-00214-000/BraTS-GLI-00214-000-seg.nii.gz,83,153,94,56,109,119,179,57,127,53,60,70
01454-000,../../DataSet/ASNR-MICCAI-BraTS2023-GLI-Challenge-TrainingData/BraTS-GLI-01454-000/BraTS-GLI-01454-000-t1c.nii.gz,../../DataSet/ASNR-MICCAI-BraTS2023-GLI-Challenge-TrainingData/BraTS-GLI-01454-000/BraTS-GLI-01454-000-t2w.nii.gz,../../DataSet/ASNR-MICCAI-BraTS2023-GLI-Challenge-TrainingData/BraTS-GLI-01454-000/BraTS-GLI-01454-000-t2f.nii.gz,../../DataSet/ASNR-MICCAI-BraTS2023-GLI-Challenge-TrainingData/BraTS-GLI-01454-000/BraTS-GLI-01454-000-t1n.nii.gz,../../DataSet/ASNR-MICCAI-BraTS2023-GLI-Challenge-TrainingData/BraTS-GLI-01454-000/BraTS-GLI-01454-000-seg.nii.gz,161,125,90,119,186,84,162,47,128,67,78,81
01428-000,../../DataSet/ASNR-MICCAI-BraTS2023-GLI-Challenge-TrainingData/BraTS-GLI-01428-000/BraTS-GLI-01428-000-t1c.nii.gz,../../DataSet/ASNR-MICCAI-BraTS2023-GLI-Challenge-TrainingData/BraTS-GLI-01428-000/BraTS-GLI-01428-000-t2w.nii.gz,../../DataSet/ASNR-MICCAI-BraTS2023-GLI-Challenge-TrainingData/BraTS-GLI-01428-000/BraTS-GLI-01428-000-t2f.nii.gz,../../DataSet/ASNR-MICCAI-BraTS2023-GLI-Challenge-TrainingData/BraTS-GLI-01428-000/BraTS-GLI-01428-000-t1n.nii.gz,../../DataSet/ASNR-MICCAI-BraTS2023-GLI-Challenge-TrainingData/BraTS-GLI-01428-000/BraTS-GLI-01428-000-seg.nii.gz,146,113,80,116,175,73,152,44,119,59,79,75
00751-000,../../DataSet/ASNR-MICCAI-BraTS2023-GLI-Challenge-TrainingData/BraTS-GLI-00751-000/BraTS-GLI-00751-000-t1c.nii.gz,../../DataSet/ASNR-MICCAI-BraTS2023-GLI-Challenge-TrainingData/BraTS-GLI-00751-000/BraTS-GLI-00751-000-t2w.nii.gz,../../DataSet/ASNR-MICCAI-BraTS2023-GLI-Challenge-TrainingData/BraTS-GLI-00751-000/BraTS-GLI-00751-000-t2f.nii.gz,../../DataSet/ASNR-MICCAI-BraTS2023-GLI-Challenge-TrainingData/BraTS-GLI-00751-000/BraTS-GLI-00751-000-t1n.nii.gz,../../DataSet/ASNR-MICCAI-BraTS2023-GLI-Challenge-TrainingData/BraTS-GLI-00751-000/BraTS-GLI-00751-000-seg.nii.gz,143,135,67,115,175,102,190,41,93,60,88,52
00780-000,../../DataSet/ASNR-MICCAI-BraTS2023-GLI-Challenge-TrainingData/BraTS-GLI-00780-000/BraTS-GLI-00780-000-t1c.nii.gz,../../DataSet/ASNR-MICCAI-BraTS2023-GLI-Challenge-TrainingData/BraTS-GLI-00780-000/BraTS-GLI-00780-000-t2w.nii.gz,../../DataSet/ASNR-MICCAI-BraTS2023-GLI-Challenge-TrainingData/BraTS-GLI-00780-000/BraTS-GLI-00780-000-t2f.nii.gz,../../DataSet/ASNR-MICCAI-BraTS2023-GLI-Challenge-TrainingData/BraTS-GLI-00780-000/BraTS-GLI-00780-000-t1n.nii.gz,../../DataSet/ASNR-MICCAI-BraTS2023-GLI-Challenge-TrainingData/BraTS-GLI-00780-000/BraTS-GLI-00780-000-seg.nii.gz,158,131,59,132,184,84,178,28,89,52,94,61
00602-001,../../DataSet/ASNR-MICCAI-BraTS2023-GLI-Challenge-TrainingData/BraTS-GLI-00602-001/BraTS-GLI-00602-001-t1c.nii.gz,../../DataSet/ASNR-MICCAI-BraTS2023-GLI-Challenge-TrainingData/BraTS-GLI-00602-001/BraTS-GLI-00602-001-t2w.nii.gz,../../DataSet/ASNR-MICCAI-BraTS2023-GLI-Challenge-TrainingData/BraTS-GLI-00602-001/BraTS-GLI-00602-001-t2f.nii.gz,../../DataSet/ASNR-MICCAI-BraTS2023-GLI-Challenge-TrainingData/BraTS-GLI-00602-001/BraTS-GLI-00602-001-t1n.nii.gz,../../DataSet/ASNR-MICCAI-BraTS2023-GLI-Challenge-TrainingData/BraTS-GLI-00602-001/BraTS-GLI-00602-001-seg.nii.gz,142,147,93,88,171,111,187,69,124,83,76,55
00519-000,../../DataSet/ASNR-MICCAI-BraTS2023-GLI-Challenge-TrainingData/BraTS-GLI-00519-000/BraTS-GLI-00519-000-t1c.nii.gz,../../DataSet/ASNR-MICCAI-BraTS2023-GLI-Challenge-TrainingData/BraTS-GLI-00519-000/BraTS-GLI-00519-000-t2w.nii.gz,../../DataSet/ASNR-MICCAI-BraTS2023-GLI-Challenge-TrainingData/BraTS-GLI-00519-000/BraTS-GLI-00519-000-t2f.nii.gz,../../DataSet/ASNR-MICCAI-BraTS2023-GLI-Challenge-TrainingData/BraTS-GLI-00519-000/BraTS-GLI-00519-000-t1n.nii.gz,../../DataSet/ASNR-MICCAI-BraTS2023-GLI-Challenge-TrainingData/BraTS-GLI-00519-000/BraTS-GLI-00519-000-seg.nii.gz,152,140,67,126,179,107,187,41,100,53,80,59
01359-000,../../DataSet/ASNR-MICCAI-BraTS2023-GLI-Challenge-TrainingData/BraTS-GLI-01359-000/BraTS-GLI-01359-000-t1c.nii.gz,../../DataSet/ASNR-MICCAI-BraTS2023-GLI-Challenge-TrainingData/BraTS-GLI-01359-000/BraTS-GLI-01359-000-t2w.nii.gz,../../DataSet/ASNR-MICCAI-BraTS2023-GLI-Challenge-TrainingData/BraTS-GLI-01359-000/BraTS-GLI-01359-000-t2f.nii.gz,../../DataSet/ASNR-MICCAI-BraTS2023-GLI-Challenge-TrainingData/BraTS-GLI-01359-000/BraTS-GLI-01359-000-t1n.nii.gz,../../DataSet/ASNR-MICCAI-BraTS2023-GLI-Challenge-TrainingData/BraTS-GLI-01359-000/BraTS-GLI-01359-000-seg.nii.gz,144,154,69,119,176,116,186,46,99,57,70,53
00178-000,../../DataSet/ASNR-MICCAI-BraTS2023-GLI-Challenge-TrainingData/BraTS-GLI-00178-000/BraTS-GLI-00178-000-t1c.nii.gz,../../DataSet/ASNR-MICCAI-BraTS2023-GLI-Challenge-TrainingData/BraTS-GLI-00178-000/BraTS-GLI-00178-000-t2w.nii.gz,../../DataSet/ASNR-MICCAI-BraTS2023-GLI-Challenge-TrainingData/BraTS-GLI-00178-000/BraTS-GLI-00178-000-t2f.nii.gz,../../DataSet/ASNR-MICCAI-BraTS2023-GLI-Challenge-TrainingData/BraTS-GLI-00178-000/BraTS-GLI-00178-000-t1n.nii.gz,../../DataSet/ASNR-MICCAI-BraTS2023-GLI-Challenge-TrainingData/BraTS-GLI-00178-000/BraTS-GLI-00178-000-seg.nii.gz,146,134,77,106,181,94,171,45,111,75,77,66
01388-000,../../DataSet/ASNR-MICCAI-BraTS2023-GLI-Challenge-TrainingData/BraTS-GLI-01388-000/BraTS-GLI-01388-000-t1c.nii.gz,../../DataSet/ASNR-MICCAI-BraTS2023-GLI-Challenge-TrainingData/BraTS-GLI-01388-000/BraTS-GLI-01388-000-t2w.nii.gz,../../DataSet/ASNR-MICCAI-BraTS2023-GLI-Challenge-TrainingData/BraTS-GLI-01388-000/BraTS-GLI-01388-000-t2f.nii.gz,../../DataSet/ASNR-MICCAI-BraTS2023-GLI-Challenge-TrainingData/BraTS-GLI-01388-000/BraTS-GLI-01388-000-t1n.nii.gz,../../DataSet/ASNR-MICCAI-BraTS2023-GLI-Challenge-TrainingData/BraTS-GLI-01388-000/BraTS-GLI-01388-000-seg.nii.gz,84,152,94,52,117,109,194,57,136,65,85,79
00756-000,../../DataSet/ASNR-MICCAI-BraTS2023-GLI-Challenge-TrainingData/BraTS-GLI-00756-000/BraTS-GLI-00756-000-t1c.nii.gz,../../DataSet/ASNR-MICCAI-BraTS2023-GLI-Challenge-TrainingData/BraTS-GLI-00756-000/BraTS-GLI-00756-000-t2w.nii.gz,../../DataSet/ASNR-MICCAI-BraTS2023-GLI-Challenge-TrainingData/BraTS-GLI-00756-000/BraTS-GLI-00756-000-t2f.nii.gz,../../DataSet/ASNR-MICCAI-BraTS2023-GLI-Challenge-TrainingData/BraTS-GLI-00756-000/BraTS-GLI-00756-000-t1n.nii.gz,../../DataSet/ASNR-MICCAI-BraTS2023-GLI-Challenge-TrainingData/BraTS-GLI-00756-000/BraTS-GLI-00756-000-seg.nii.gz,96,108,102,64,127,58,153,68,139,63,95,71
00441-000,../../DataSet/ASNR-MICCAI-BraTS2023-GLI-Challenge-TrainingData/BraTS-GLI-00441-000/BraTS-GLI-00441-000-t1c.nii.gz,../../DataSet/ASNR-MICCAI-BraTS2023-GLI-Challenge-TrainingData/BraTS-GLI-00441-000/BraTS-GLI-00441-000-t2w.nii.gz,../../DataSet/ASNR-MICCAI-BraTS2023-GLI-Challenge-TrainingData/BraTS-GLI-00441-000/BraTS-GLI-00441-000-t2f.nii.gz,../../DataSet/ASNR-MICCAI-BraTS2023-GLI-Challenge-TrainingData/BraTS-GLI-00441-000/BraTS-GLI-00441-000-t1n.nii.gz,../../DataSet/ASNR-MICCAI-BraTS2023-GLI-Challenge-TrainingData/BraTS-GLI-00441-000/BraTS-GLI-00441-000-seg.nii.gz,136,163,25,109,169,137,191,8,49,60,54,41
01660-000,../../DataSet/ASNR-MICCAI-BraTS2023-GLI-Challenge-TrainingData/BraTS-GLI-01660-000/BraTS-GLI-01660-000-t1c.nii.gz,../../DataSet/ASNR-MICCAI-BraTS2023-GLI-Challenge-TrainingData/BraTS-GLI-01660-000/BraTS-GLI-01660-000-t2w.nii.gz,../../DataSet/ASNR-MICCAI-BraTS2023-GLI-Challenge-TrainingData/BraTS-GLI-01660-000/BraTS-GLI-01660-000-t2f.nii.gz,../../DataSet/ASNR-MICCAI-BraTS2023-GLI-Challenge-TrainingData/BraTS-GLI-01660-000/BraTS-GLI-01660-000-t1n.nii.gz,../../DataSet/ASNR-MICCAI-BraTS2023-GLI-Challenge-TrainingData/BraTS-GLI-01660-000/BraTS-GLI-01660-000-seg.nii.gz,100,113,105,67,132,72,164,73,135,65,92,62
00020-000,../../DataSet/ASNR-MICCAI-BraTS2023-GLI-Challenge-TrainingData/BraTS-GLI-00020-000/BraTS-GLI-00020-000-t1c.nii.gz,../../DataSet/ASNR-MICCAI-BraTS2023-GLI-Challenge-TrainingData/BraTS-GLI-00020-000/BraTS-GLI-00020-000-t2w.nii.gz,../../DataSet/ASNR-MICCAI-BraTS2023-GLI-Challenge-TrainingData/BraTS-GLI-00020-000/BraTS-GLI-00020-000-t2f.nii.gz,../../DataSet/ASNR-MICCAI-BraTS2023-GLI-Challenge-TrainingData/BraTS-GLI-00020-000/BraTS-GLI-00020-000-t1n.nii.gz,../../DataSet/ASNR-MICCAI-BraTS2023-GLI-Challenge-TrainingData/BraTS-GLI-00020-000/BraTS-GLI-00020-000-seg.nii.gz,90,172,70,66,125,130,205,46,94,59,75,48
00787-000,../../DataSet/ASNR-MICCAI-BraTS2023-GLI-Challenge-TrainingData/BraTS-GLI-00787-000/BraTS-GLI-00787-000-t1c.nii.gz,../../DataSet/ASNR-MICCAI-BraTS2023-GLI-Challenge-TrainingData/BraTS-GLI-00787-000/BraTS-GLI-00787-000-t2w.nii.gz,../../DataSet/ASNR-MICCAI-BraTS2023-GLI-Challenge-TrainingData/BraTS-GLI-00787-000/BraTS-GLI-00787-000-t2f.nii.gz,../../DataSet/ASNR-MICCAI-BraTS2023-GLI-Challenge-TrainingData/BraTS-GLI-00787-000/BraTS-GLI-00787-000-t1n.nii.gz,../../DataSet/ASNR-MICCAI-BraTS2023-GLI-Challenge-TrainingData/BraTS-GLI-00787-000/BraTS-GLI-00787-000-seg.nii.gz,154,129,67,126,182,85,180,28,107,56,95,79
00565-000,../../DataSet/ASNR-MICCAI-BraTS2023-GLI-Challenge-TrainingData/BraTS-GLI-00565-000/BraTS-GLI-00565-000-t1c.nii.gz,../../DataSet/ASNR-MICCAI-BraTS2023-GLI-Challenge-TrainingData/BraTS-GLI-00565-000/BraTS-GLI-00565-000-t2w.nii.gz,../../DataSet/ASNR-MICCAI-BraTS2023-GLI-Challenge-TrainingData/BraTS-GLI-00565-000/BraTS-GLI-00565-000-t2f.nii.gz,../../DataSet/ASNR-MICCAI-BraTS2023-GLI-Challenge-TrainingData/BraTS-GLI-00565-000/BraTS-GLI-00565-000-t1n.nii.gz,../../DataSet/ASNR-MICCAI-BraTS2023-GLI-Challenge-TrainingData/BraTS-GLI-00565-000/BraTS-GLI-00565-000-seg.nii.gz,157,151,63,136,181,107,192,31,102,45,85,71
01482-000,../../DataSet/ASNR-MICCAI-BraTS2023-GLI-Challenge-TrainingData/BraTS-GLI-01482-000/BraTS-GLI-01482-000-t1c.nii.gz,../../DataSet/ASNR-MICCAI-BraTS2023-GLI-Challenge-TrainingData/BraTS-GLI-01482-000/BraTS-GLI-01482-000-t2w.nii.gz,../../DataSet/ASNR-MICCAI-BraTS2023-GLI-Challenge-TrainingData/BraTS-GLI-01482-000/BraTS-GLI-01482-000-t2f.nii.gz,../../DataSet/ASNR-MICCAI-BraTS2023-GLI-Challenge-TrainingData/BraTS-GLI-01482-000/BraTS-GLI-01482-000-t1n.nii.gz,../../DataSet/ASNR-MICCAI-BraTS2023-GLI-Challenge-TrainingData/BraTS-GLI-01482-000/BraTS-GLI-01482-000-seg.nii.gz,163,183,76,135,186,149,216,41,110,51,67,69
00104-000,../../DataSet/ASNR-MICCAI-BraTS2023-GLI-Challenge-TrainingData/BraTS-GLI-00104-000/BraTS-GLI-00104-000-t1c.nii.gz,../../DataSet/ASNR-MICCAI-BraTS2023-GLI-Challenge-TrainingData/BraTS-GLI-00104-000/BraTS-GLI-00104-000-t2w.nii.gz,../../DataSet/ASNR-MICCAI-BraTS2023-GLI-Challenge-TrainingData/BraTS-GLI-00104-000/BraTS-GLI-00104-000-t2f.nii.gz,../../DataSet/ASNR-MICCAI-BraTS2023-GLI-Challenge-TrainingData/BraTS-GLI-00104-000/BraTS-GLI-00104-000-t1n.nii.gz,../../DataSet/ASNR-MICCAI-BraTS2023-GLI-Challenge-TrainingData/BraTS-GLI-00104-000/BraTS-GLI-00104-000-seg.nii.gz,132,105,104,102,156,66,140,83,135,54,74,52
01032-000,../../DataSet/ASNR-MICCAI-BraTS2023-GLI-Challenge-TrainingData/BraTS-GLI-01032-000/BraTS-GLI-01032-000-t1c.nii.gz,../../DataSet/ASNR-MICCAI-BraTS2023-GLI-Challenge-TrainingData/BraTS-GLI-01032-000/BraTS-GLI-01032-000-t2w.nii.gz,../../DataSet/ASNR-MICCAI-BraTS2023-GLI-Challenge-TrainingData/BraTS-GLI-01032-000/BraTS-GLI-01032-000-t2f.nii.gz,../../DataSet/ASNR-MICCAI-BraTS2023-GLI-Challenge-TrainingData/BraTS-GLI-01032-000/BraTS-GLI-01032-000-t1n.nii.gz,../../DataSet/ASNR-MICCAI-BraTS2023-GLI-Challenge-TrainingData/BraTS-GLI-01032-000/BraTS-GLI-01032-000-seg.nii.gz,149,100,93,120,178,50,145,61,126,58,95,65
01453-000,../../DataSet/ASNR-MICCAI-BraTS2023-GLI-Challenge-TrainingData/BraTS-GLI-01453-000/BraTS-GLI-01453-000-t1c.nii.gz,../../DataSet/ASNR-MICCAI-BraTS2023-GLI-Challenge-TrainingData/BraTS-GLI-01453-000/BraTS-GLI-01453-000-t2w.nii.gz,../../DataSet/ASNR-MICCAI-BraTS2023-GLI-Challenge-TrainingData/BraTS-GLI-01453-000/BraTS-GLI-01453-000-t2f.nii.gz,../../DataSet/ASNR-MICCAI-BraTS2023-GLI-Challenge-TrainingData/BraTS-GLI-01453-000/BraTS-GLI-01453-000-t1n.nii.gz,../../DataSet/ASNR-MICCAI-BraTS2023-GLI-Challenge-TrainingData/BraTS-GLI-01453-000/BraTS-GLI-01453-000-seg.nii.gz,83,121,65,66,106,95,150,44,94,40,55,50
00630-001,../../DataSet/ASNR-MICCAI-BraTS2023-GLI-Challenge-TrainingData/BraTS-GLI-00630-001/BraTS-GLI-00630-001-t1c.nii.gz,../../DataSet/ASNR-MICCAI-BraTS2023-GLI-Challenge-TrainingData/BraTS-GLI-00630-001/BraTS-GLI-00630-001-t2w.nii.gz,../../DataSet/ASNR-MICCAI-BraTS2023-GLI-Challenge-TrainingData/BraTS-GLI-00630-001/BraTS-GLI-00630-001-t2f.nii.gz,../../DataSet/ASNR-MICCAI-BraTS2023-GLI-Challenge-TrainingData/BraTS-GLI-00630-001/BraTS-GLI-00630-001-t1n.nii.gz,../../DataSet/ASNR-MICCAI-BraTS2023-GLI-Challenge-TrainingData/BraTS-GLI-00630-001/BraTS-GLI-00630-001-seg.nii.gz,138,129,78,102,175,92,169,34,118,73,77,84
00806-000,../../DataSet/ASNR-MICCAI-BraTS2023-GLI-Challenge-TrainingData/BraTS-GLI-00806-000/BraTS-GLI-00806-000-t1c.nii.gz,../../DataSet/ASNR-MICCAI-BraTS2023-GLI-Challenge-TrainingData/BraTS-GLI-00806-000/BraTS-GLI-00806-000-t2w.nii.gz,../../DataSet/ASNR-MICCAI-BraTS2023-GLI-Challenge-TrainingData/BraTS-GLI-00806-000/BraTS-GLI-00806-000-t2f.nii.gz,../../DataSet/ASNR-MICCAI-BraTS2023-GLI-Challenge-TrainingData/BraTS-GLI-00806-000/BraTS-GLI-00806-000-t1n.nii.gz,../../DataSet/ASNR-MICCAI-BraTS2023-GLI-Challenge-TrainingData/BraTS-GLI-00806-000/BraTS-GLI-00806-000-seg.nii.gz,101,103,102,71,132,58,150,66,136,61,92,70
01234-000,../../DataSet/ASNR-MICCAI-BraTS2023-GLI-Challenge-TrainingData/BraTS-GLI-01234-000/BraTS-GLI-01234-000-t1c.nii.gz,../../DataSet/ASNR-MICCAI-BraTS2023-GLI-Challenge-TrainingData/BraTS-GLI-01234-000/BraTS-GLI-01234-000-t2w.nii.gz,../../DataSet/ASNR-MICCAI-BraTS2023-GLI-Challenge-TrainingData/BraTS-GLI-01234-000/BraTS-GLI-01234-000-t2f.nii.gz,../../DataSet/ASNR-MICCAI-BraTS2023-GLI-Challenge-TrainingData/BraTS-GLI-01234-000/BraTS-GLI-01234-000-t1n.nii.gz,../../DataSet/ASNR-MICCAI-BraTS2023-GLI-Challenge-TrainingData/BraTS-GLI-01234-000/BraTS-GLI-01234-000-seg.nii.gz,133,133,120,120,151,103,158,94,140,31,55,46
01123-000,../../DataSet/ASNR-MICCAI-BraTS2023-GLI-Challenge-TrainingData/BraTS-GLI-01123-000/BraTS-GLI-01123-000-t1c.nii.gz,../../DataSet/ASNR-MICCAI-BraTS2023-GLI-Challenge-TrainingData/BraTS-GLI-01123-000/BraTS-GLI-01123-000-t2w.nii.gz,../../DataSet/ASNR-MICCAI-BraTS2023-GLI-Challenge-TrainingData/BraTS-GLI-01123-000/BraTS-GLI-01123-000-t2f.nii.gz,../../DataSet/ASNR-MICCAI-BraTS2023-GLI-Challenge-TrainingData/BraTS-GLI-01123-000/BraTS-GLI-01123-000-t1n.nii.gz,../../DataSet/ASNR-MICCAI-BraTS2023-GLI-Challenge-TrainingData/BraTS-GLI-01123-000/BraTS-GLI-01123-000-seg.nii.gz,161,136,61,133,187,96,181,36,90,54,85,54
00581-000,../../DataSet/ASNR-MICCAI-BraTS2023-GLI-Challenge-TrainingData/BraTS-GLI-00581-000/BraTS-GLI-00581-000-t1c.nii.gz,../../DataSet/ASNR-MICCAI-BraTS2023-GLI-Challenge-TrainingData/BraTS-GLI-00581-000/BraTS-GLI-00581-000-t2w.nii.gz,../../DataSet/ASNR-MICCAI-BraTS2023-GLI-Challenge-TrainingData/BraTS-GLI-00581-000/BraTS-GLI-00581-000-t2f.nii.gz,../../DataSet/ASNR-MICCAI-BraTS2023-GLI-Challenge-TrainingData/BraTS-GLI-00581-000/BraTS-GLI-00581-000-t1n.nii.gz,../../DataSet/ASNR-MICCAI-BraTS2023-GLI-Challenge-TrainingData/BraTS-GLI-00581-000/BraTS-GLI-00581-000-seg.nii.gz,94,117,76,62,133,75,169,40,107,71,94,67
01007-000,../../DataSet/ASNR-MICCAI-BraTS2023-GLI-Challenge-TrainingData/BraTS-GLI-01007-000/BraTS-GLI-01007-000-t1c.nii.gz,../../DataSet/ASNR-MICCAI-BraTS2023-GLI-Challenge-TrainingData/BraTS-GLI-01007-000/BraTS-GLI-01007-000-t2w.nii.gz,../../DataSet/ASNR-MICCAI-BraTS2023-GLI-Challenge-TrainingData/BraTS-GLI-01007-000/BraTS-GLI-01007-000-t2f.nii.gz,../../DataSet/ASNR-MICCAI-BraTS2023-GLI-Challenge-TrainingData/BraTS-GLI-01007-000/BraTS-GLI-01007-000-t1n.nii.gz,../../DataSet/ASNR-MICCAI-BraTS2023-GLI-Challenge-TrainingData/BraTS-GLI-01007-000/BraTS-GLI-01007-000-seg.nii.gz,155,146,55,133,185,119,179,36,80,52,60,44
00131-000,../../DataSet/ASNR-MICCAI-BraTS2023-GLI-Challenge-TrainingData/BraTS-GLI-00131-000/BraTS-GLI-00131-000-t1c.nii.gz,../../DataSet/ASNR-MICCAI-BraTS2023-GLI-Challenge-TrainingData/BraTS-GLI-00131-000/BraTS-GLI-00131-000-t2w.nii.gz,../../DataSet/ASNR-MICCAI-BraTS2023-GLI-Challenge-TrainingData/BraTS-GLI-00131-000/BraTS-GLI-00131-000-t2f.nii.gz,../../DataSet/ASNR-MICCAI-BraTS2023-GLI-Challenge-TrainingData/BraTS-GLI-00131-000/BraTS-GLI-00131-000-t1n.nii.gz,../../DataSet/ASNR-MICCAI-BraTS2023-GLI-Challenge-TrainingData/BraTS-GLI-00131-000/BraTS-GLI-00131-000-seg.nii.gz,154,158,86,126,181,124,202,55,122,55,78,67
00550-000,../../DataSet/ASNR-MICCAI-BraTS2023-GLI-Challenge-TrainingData/BraTS-GLI-00550-000/BraTS-GLI-00550-000-t1c.nii.gz,../../DataSet/ASNR-MICCAI-BraTS2023-GLI-Challenge-TrainingData/BraTS-GLI-00550-000/BraTS-GLI-00550-000-t2w.nii.gz,../../DataSet/ASNR-MICCAI-BraTS2023-GLI-Challenge-TrainingData/BraTS-GLI-00550-000/BraTS-GLI-00550-000-t2f.nii.gz,../../DataSet/ASNR-MICCAI-BraTS2023-GLI-Challenge-TrainingData/BraTS-GLI-00550-000/BraTS-GLI-00550-000-t1n.nii.gz,../../DataSet/ASNR-MICCAI-BraTS2023-GLI-Challenge-TrainingData/BraTS-GLI-00550-000/BraTS-GLI-00550-000-seg.nii.gz,143,104,48,122,169,78,142,28,70,47,64,42
01310-000,../../DataSet/ASNR-MICCAI-BraTS2023-GLI-Challenge-TrainingData/BraTS-GLI-01310-000/BraTS-GLI-01310-000-t1c.nii.gz,../../DataSet/ASNR-MICCAI-BraTS2023-GLI-Challenge-TrainingData/BraTS-GLI-01310-000/BraTS-GLI-01310-000-t2w.nii.gz,../../DataSet/ASNR-MICCAI-BraTS2023-GLI-Challenge-TrainingData/BraTS-GLI-01310-000/BraTS-GLI-01310-000-t2f.nii.gz,../../DataSet/ASNR-MICCAI-BraTS2023-GLI-Challenge-TrainingData/BraTS-GLI-01310-000/BraTS-GLI-01310-000-t1n.nii.gz,../../DataSet/ASNR-MICCAI-BraTS2023-GLI-Challenge-TrainingData/BraTS-GLI-01310-000/BraTS-GLI-01310-000-seg.nii.gz,96,178,78,72,118,134,206,46,108,46,72,62
01248-000,../../DataSet/ASNR-MICCAI-BraTS2023-GLI-Challenge-TrainingData/BraTS-GLI-01248-000/BraTS-GLI-01248-000-t1c.nii.gz,../../DataSet/ASNR-MICCAI-BraTS2023-GLI-Challenge-TrainingData/BraTS-GLI-01248-000/BraTS-GLI-01248-000-t2w.nii.gz,../../DataSet/ASNR-MICCAI-BraTS2023-GLI-Challenge-TrainingData/BraTS-GLI-01248-000/BraTS-GLI-01248-000-t2f.nii.gz,../../DataSet/ASNR-MICCAI-BraTS2023-GLI-Challenge-TrainingData/BraTS-GLI-01248-000/BraTS-GLI-01248-000-t1n.nii.gz,../../DataSet/ASNR-MICCAI-BraTS2023-GLI-Challenge-TrainingData/BraTS-GLI-01248-000/BraTS-GLI-01248-000-seg.nii.gz,157,144,62,133,181,97,190,35,94,48,93,59
00221-000,../../DataSet/ASNR-MICCAI-BraTS2023-GLI-Challenge-TrainingData/BraTS-GLI-00221-000/BraTS-GLI-00221-000-t1c.nii.gz,../../DataSet/ASNR-MICCAI-BraTS2023-GLI-Challenge-TrainingData/BraTS-GLI-00221-000/BraTS-GLI-00221-000-t2w.nii.gz,../../DataSet/ASNR-MICCAI-BraTS2023-GLI-Challenge-TrainingData/BraTS-GLI-00221-000/BraTS-GLI-00221-000-t2f.nii.gz,../../DataSet/ASNR-MICCAI-BraTS2023-GLI-Challenge-TrainingData/BraTS-GLI-00221-000/BraTS-GLI-00221-000-t1n.nii.gz,../../DataSet/ASNR-MICCAI-BraTS2023-GLI-Challenge-TrainingData/BraTS-GLI-00221-000/BraTS-GLI-00221-000-seg.nii.gz,100,189,75,84,116,164,210,55,101,32,46,46
00586-000,../../DataSet/ASNR-MICCAI-BraTS2023-GLI-Challenge-TrainingData/BraTS-GLI-00586-000/BraTS-GLI-00586-000-t1c.nii.gz,../../DataSet/ASNR-MICCAI-BraTS2023-GLI-Challenge-TrainingData/BraTS-GLI-00586-000/BraTS-GLI-00586-000-t2w.nii.gz,../../DataSet/ASNR-MICCAI-BraTS2023-GLI-Challenge-TrainingData/BraTS-GLI-00586-000/BraTS-GLI-00586-000-t2f.nii.gz,../../DataSet/ASNR-MICCAI-BraTS2023-GLI-Challenge-TrainingData/BraTS-GLI-00586-000/BraTS-GLI-00586-000-t1n.nii.gz,../../DataSet/ASNR-MICCAI-BraTS2023-GLI-Challenge-TrainingData/BraTS-GLI-00586-000/BraTS-GLI-00586-000-seg.nii.gz,136,175,88,115,163,139,214,48,125,48,75,77
00640-000,../../DataSet/ASNR-MICCAI-BraTS2023-GLI-Challenge-TrainingData/BraTS-GLI-00640-000/BraTS-GLI-00640-000-t1c.nii.gz,../../DataSet/ASNR-MICCAI-BraTS2023-GLI-Challenge-TrainingData/BraTS-GLI-00640-000/BraTS-GLI-00640-000-t2w.nii.gz,../../DataSet/ASNR-MICCAI-BraTS2023-GLI-Challenge-TrainingData/BraTS-GLI-00640-000/BraTS-GLI-00640-000-t2f.nii.gz,../../DataSet/ASNR-MICCAI-BraTS2023-GLI-Challenge-TrainingData/BraTS-GLI-00640-000/BraTS-GLI-00640-000-t1n.nii.gz,../../DataSet/ASNR-MICCAI-BraTS2023-GLI-Challenge-TrainingData/BraTS-GLI-00640-000/BraTS-GLI-00640-000-seg.nii.gz,102,105,94,65,145,73,142,61,134,80,69,73
00691-000,../../DataSet/ASNR-MICCAI-BraTS2023-GLI-Challenge-TrainingData/BraTS-GLI-00691-000/BraTS-GLI-00691-000-t1c.nii.gz,../../DataSet/ASNR-MICCAI-BraTS2023-GLI-Challenge-TrainingData/BraTS-GLI-00691-000/BraTS-GLI-00691-000-t2w.nii.gz,../../DataSet/ASNR-MICCAI-BraTS2023-GLI-Challenge-TrainingData/BraTS-GLI-00691-000/BraTS-GLI-00691-000-t2f.nii.gz,../../DataSet/ASNR-MICCAI-BraTS2023-GLI-Challenge-TrainingData/BraTS-GLI-00691-000/BraTS-GLI-00691-000-t1n.nii.gz,../../DataSet/ASNR-MICCAI-BraTS2023-GLI-Challenge-TrainingData/BraTS-GLI-00691-000/BraTS-GLI-00691-000-seg.nii.gz,148,120,82,125,171,72,157,59,115,46,85,56
01317-000,../../DataSet/ASNR-MICCAI-BraTS2023-GLI-Challenge-TrainingData/BraTS-GLI-01317-000/BraTS-GLI-01317-000-t1c.nii.gz,../../DataSet/ASNR-MICCAI-BraTS2023-GLI-Challenge-TrainingData/BraTS-GLI-01317-000/BraTS-GLI-01317-000-t2w.nii.gz,../../DataSet/ASNR-MICCAI-BraTS2023-GLI-Challenge-TrainingData/BraTS-GLI-01317-000/BraTS-GLI-01317-000-t2f.nii.gz,../../DataSet/ASNR-MICCAI-BraTS2023-GLI-Challenge-TrainingData/BraTS-GLI-01317-000/BraTS-GLI-01317-000-t1n.nii.gz,../../DataSet/ASNR-MICCAI-BraTS2023-GLI-Challenge-TrainingData/BraTS-GLI-01317-000/BraTS-GLI-01317-000-seg.nii.gz,82,149,60,53,117,113,193,30,90,64,80,60
00557-000,../../DataSet/ASNR-MICCAI-BraTS2023-GLI-Challenge-TrainingData/BraTS-GLI-00557-000/BraTS-GLI-00557-000-t1c.nii.gz,../../DataSet/ASNR-MICCAI-BraTS2023-GLI-Challenge-TrainingData/BraTS-GLI-00557-000/BraTS-GLI-00557-000-t2w.nii.gz,../../DataSet/ASNR-MICCAI-BraTS2023-GLI-Challenge-TrainingData/BraTS-GLI-00557-000/BraTS-GLI-00557-000-t2f.nii.gz,../../DataSet/ASNR-MICCAI-BraTS2023-GLI-Challenge-TrainingData/BraTS-GLI-00557-000/BraTS-GLI-00557-000-t1n.nii.gz,../../DataSet/ASNR-MICCAI-BraTS2023-GLI-Challenge-TrainingData/BraTS-GLI-00557-000/BraTS-GLI-00557-000-seg.nii.gz,98,112,110,75,121,87,139,89,131,46,52,42
01189-000,../../DataSet/ASNR-MICCAI-BraTS2023-GLI-Challenge-TrainingData/BraTS-GLI-01189-000/BraTS-GLI-01189-000-t1c.nii.gz,../../DataSet/ASNR-MICCAI-BraTS2023-GLI-Challenge-TrainingData/BraTS-GLI-01189-000/BraTS-GLI-01189-000-t2w.nii.gz,../../DataSet/ASNR-MICCAI-BraTS2023-GLI-Challenge-TrainingData/BraTS-GLI-01189-000/BraTS-GLI-01189-000-t2f.nii.gz,../../DataSet/ASNR-MICCAI-BraTS2023-GLI-Challenge-TrainingData/BraTS-GLI-01189-000/BraTS-GLI-01189-000-t1n.nii.gz,../../DataSet/ASNR-MICCAI-BraTS2023-GLI-Challenge-TrainingData/BraTS-GLI-01189-000/BraTS-GLI-01189-000-seg.nii.gz,87,120,91,59,117,84,158,61,129,58,74,68
00379-000,../../DataSet/ASNR-MICCAI-BraTS2023-GLI-Challenge-TrainingData/BraTS-GLI-00379-000/BraTS-GLI-00379-000-t1c.nii.gz,../../DataSet/ASNR-MICCAI-BraTS2023-GLI-Challenge-TrainingData/BraTS-GLI-00379-000/BraTS-GLI-00379-000-t2w.nii.gz,../../DataSet/ASNR-MICCAI-BraTS2023-GLI-Challenge-TrainingData/BraTS-GLI-00379-000/BraTS-GLI-00379-000-t2f.nii.gz,../../DataSet/ASNR-MICCAI-BraTS2023-GLI-Challenge-TrainingData/BraTS-GLI-00379-000/BraTS-GLI-00379-000-t1n.nii.gz,../../DataSet/ASNR-MICCAI-BraTS2023-GLI-Challenge-TrainingData/BraTS-GLI-00379-000/BraTS-GLI-00379-000-seg.nii.gz,158,141,99,138,180,120,162,84,121,42,42,37
01158-000,../../DataSet/ASNR-MICCAI-BraTS2023-GLI-Challenge-TrainingData/BraTS-GLI-01158-000/BraTS-GLI-01158-000-t1c.nii.gz,../../DataSet/ASNR-MICCAI-BraTS2023-GLI-Challenge-TrainingData/BraTS-GLI-01158-000/BraTS-GLI-01158-000-t2w.nii.gz,../../DataSet/ASNR-MICCAI-BraTS2023-GLI-Challenge-TrainingData/BraTS-GLI-01158-000/BraTS-GLI-01158-000-t2f.nii.gz,../../DataSet/ASNR-MICCAI-BraTS2023-GLI-Challenge-TrainingData/BraTS-GLI-01158-000/BraTS-GLI-01158-000-t1n.nii.gz,../../DataSet/ASNR-MICCAI-BraTS2023-GLI-Challenge-TrainingData/BraTS-GLI-01158-000/BraTS-GLI-01158-000-seg.nii.gz,84,110,83,59,112,69,153,53,118,53,84,65
00718-000,../../DataSet/ASNR-MICCAI-BraTS2023-GLI-Challenge-TrainingData/BraTS-GLI-00718-000/BraTS-GLI-00718-000-t1c.nii.gz,../../DataSet/ASNR-MICCAI-BraTS2023-GLI-Challenge-TrainingData/BraTS-GLI-00718-000/BraTS-GLI-00718-000-t2w.nii.gz,../../DataSet/ASNR-MICCAI-BraTS2023-GLI-Challenge-TrainingData/BraTS-GLI-00718-000/BraTS-GLI-00718-000-t2f.nii.gz,../../DataSet/ASNR-MICCAI-BraTS2023-GLI-Challenge-TrainingData/BraTS-GLI-00718-000/BraTS-GLI-00718-000-t1n.nii.gz,../../DataSet/ASNR-MICCAI-BraTS2023-GLI-Challenge-TrainingData/BraTS-GLI-00718-000/BraTS-GLI-00718-000-seg.nii.gz,88,166,64,55,119,113,206,29,105,64,93,76
00478-001,../../DataSet/ASNR-MICCAI-BraTS2023-GLI-Challenge-TrainingData/BraTS-GLI-00478-001/BraTS-GLI-00478-001-t1c.nii.gz,../../DataSet/ASNR-MICCAI-BraTS2023-GLI-Challenge-TrainingData/BraTS-GLI-00478-001/BraTS-GLI-00478-001-t2w.nii.gz,../../DataSet/ASNR-MICCAI-BraTS2023-GLI-Challenge-TrainingData/BraTS-GLI-00478-001/BraTS-GLI-00478-001-t2f.nii.gz,../../DataSet/ASNR-MICCAI-BraTS2023-GLI-Challenge-TrainingData/BraTS-GLI-00478-001/BraTS-GLI-00478-001-t1n.nii.gz,../../DataSet/ASNR-MICCAI-BraTS2023-GLI-Challenge-TrainingData/BraTS-GLI-00478-001/BraTS-GLI-00478-001-seg.nii.gz,87,135,98,59,117,97,173,67,133,58,76,66
00801-000,../../DataSet/ASNR-MICCAI-BraTS2023-GLI-Challenge-TrainingData/BraTS-GLI-00801-000/BraTS-GLI-00801-000-t1c.nii.gz,../../DataSet/ASNR-MICCAI-BraTS2023-GLI-Challenge-TrainingData/BraTS-GLI-00801-000/BraTS-GLI-00801-000-t2w.nii.gz,../../DataSet/ASNR-MICCAI-BraTS2023-GLI-Challenge-TrainingData/BraTS-GLI-00801-000/BraTS-GLI-00801-000-t2f.nii.gz,../../DataSet/ASNR-MICCAI-BraTS2023-GLI-Challenge-TrainingData/BraTS-GLI-00801-000/BraTS-GLI-00801-000-t1n.nii.gz,../../DataSet/ASNR-MICCAI-BraTS2023-GLI-Challenge-TrainingData/BraTS-GLI-00801-000/BraTS-GLI-00801-000-seg.nii.gz,80,149,69,54,110,109,185,42,107,56,76,65
00520-001,../../DataSet/ASNR-MICCAI-BraTS2023-GLI-Challenge-TrainingData/BraTS-GLI-00520-001/BraTS-GLI-00520-001-t1c.nii.gz,../../DataSet/ASNR-MICCAI-BraTS2023-GLI-Challenge-TrainingData/BraTS-GLI-00520-001/BraTS-GLI-00520-001-t2w.nii.gz,../../DataSet/ASNR-MICCAI-BraTS2023-GLI-Challenge-TrainingData/BraTS-GLI-00520-001/BraTS-GLI-00520-001-t2f.nii.gz,../../DataSet/ASNR-MICCAI-BraTS2023-GLI-Challenge-TrainingData/BraTS-GLI-00520-001/BraTS-GLI-00520-001-t1n.nii.gz,../../DataSet/ASNR-MICCAI-BraTS2023-GLI-Challenge-TrainingData/BraTS-GLI-00520-001/BraTS-GLI-00520-001-seg.nii.gz,156,145,90,133,179,119,172,67,115,46,53,48
00305-000,../../DataSet/ASNR-MICCAI-BraTS2023-GLI-Challenge-TrainingData/BraTS-GLI-00305-000/BraTS-GLI-00305-000-t1c.nii.gz,../../DataSet/ASNR-MICCAI-BraTS2023-GLI-Challenge-TrainingData/BraTS-GLI-00305-000/BraTS-GLI-00305-000-t2w.nii.gz,../../DataSet/ASNR-MICCAI-BraTS2023-GLI-Challenge-TrainingData/BraTS-GLI-00305-000/BraTS-GLI-00305-000-t2f.nii.gz,../../DataSet/ASNR-MICCAI-BraTS2023-GLI-Challenge-TrainingData/BraTS-GLI-00305-000/BraTS-GLI-00305-000-t1n.nii.gz,../../DataSet/ASNR-MICCAI-BraTS2023-GLI-Challenge-TrainingData/BraTS-GLI-00305-000/BraTS-GLI-00305-000-seg.nii.gz,154,124,95,129,183,71,165,66,130,54,94,64
01124-000,../../DataSet/ASNR-MICCAI-BraTS2023-GLI-Challenge-TrainingData/BraTS-GLI-01124-000/BraTS-GLI-01124-000-t1c.nii.gz,../../DataSet/ASNR-MICCAI-BraTS2023-GLI-Challenge-TrainingData/BraTS-GLI-01124-000/BraTS-GLI-01124-000-t2w.nii.gz,../../DataSet/ASNR-MICCAI-BraTS2023-GLI-Challenge-TrainingData/BraTS-GLI-01124-000/BraTS-GLI-01124-000-t2f.nii.gz,../../DataSet/ASNR-MICCAI-BraTS2023-GLI-Challenge-TrainingData/BraTS-GLI-01124-000/BraTS-GLI-01124-000-t1n.nii.gz,../../DataSet/ASNR-MICCAI-BraTS2023-GLI-Challenge-TrainingData/BraTS-GLI-01124-000/BraTS-GLI-01124-000-seg.nii.gz,134,139,77,110,160,111,163,52,102,50,52,50
01319-000,../../DataSet/ASNR-MICCAI-BraTS2023-GLI-Challenge-TrainingData/BraTS-GLI-01319-000/BraTS-GLI-01319-000-t1c.nii.gz,../../DataSet/ASNR-MICCAI-BraTS2023-GLI-Challenge-TrainingData/BraTS-GLI-01319-000/BraTS-GLI-01319-000-t2w.nii.gz,../../DataSet/ASNR-MICCAI-BraTS2023-GLI-Challenge-TrainingData/BraTS-GLI-01319-000/BraTS-GLI-01319-000-t2f.nii.gz,../../DataSet/ASNR-MICCAI-BraTS2023-GLI-Challenge-TrainingData/BraTS-GLI-01319-000/BraTS-GLI-01319-000-t1n.nii.gz,../../DataSet/ASNR-MICCAI-BraTS2023-GLI-Challenge-TrainingData/BraTS-GLI-01319-000/BraTS-GLI-01319-000-seg.nii.gz,141,161,103,107,167,127,195,78,132,60,68,54
01187-000,../../DataSet/ASNR-MICCAI-BraTS2023-GLI-Challenge-TrainingData/BraTS-GLI-01187-000/BraTS-GLI-01187-000-t1c.nii.gz,../../DataSet/ASNR-MICCAI-BraTS2023-GLI-Challenge-TrainingData/BraTS-GLI-01187-000/BraTS-GLI-01187-000-t2w.nii.gz,../../DataSet/ASNR-MICCAI-BraTS2023-GLI-Challenge-TrainingData/BraTS-GLI-01187-000/BraTS-GLI-01187-000-t2f.nii.gz,../../DataSet/ASNR-MICCAI-BraTS2023-GLI-Challenge-TrainingData/BraTS-GLI-01187-000/BraTS-GLI-01187-000-t1n.nii.gz,../../DataSet/ASNR-MICCAI-BraTS2023-GLI-Challenge-TrainingData/BraTS-GLI-01187-000/BraTS-GLI-01187-000-seg.nii.gz,133,74,96,118,153,49,107,66,130,35,58,64
00645-001,../../DataSet/ASNR-MICCAI-BraTS2023-GLI-Challenge-TrainingData/BraTS-GLI-00645-001/BraTS-GLI-00645-001-t1c.nii.gz,../../DataSet/ASNR-MICCAI-BraTS2023-GLI-Challenge-TrainingData/BraTS-GLI-00645-001/BraTS-GLI-00645-001-t2w.nii.gz,../../DataSet/ASNR-MICCAI-BraTS2023-GLI-Challenge-TrainingData/BraTS-GLI-00645-001/BraTS-GLI-00645-001-t2f.nii.gz,../../DataSet/ASNR-MICCAI-BraTS2023-GLI-Challenge-TrainingData/BraTS-GLI-00645-001/BraTS-GLI-00645-001-t1n.nii.gz,../../DataSet/ASNR-MICCAI-BraTS2023-GLI-Challenge-TrainingData/BraTS-GLI-00645-001/BraTS-GLI-00645-001-seg.nii.gz,141,111,111,123,177,91,151,77,133,54,60,56
00401-000,../../DataSet/ASNR-MICCAI-BraTS2023-GLI-Challenge-TrainingData/BraTS-GLI-00401-000/BraTS-GLI-00401-000-t1c.nii.gz,../../DataSet/ASNR-MICCAI-BraTS2023-GLI-Challenge-TrainingData/BraTS-GLI-00401-000/BraTS-GLI-00401-000-t2w.nii.gz,../../DataSet/ASNR-MICCAI-BraTS2023-GLI-Challenge-TrainingData/BraTS-GLI-00401-000/BraTS-GLI-00401-000-t2f.nii.gz,../../DataSet/ASNR-MICCAI-BraTS2023-GLI-Challenge-TrainingData/BraTS-GLI-00401-000/BraTS-GLI-00401-000-t1n.nii.gz,../../DataSet/ASNR-MICCAI-BraTS2023-GLI-Challenge-TrainingData/BraTS-GLI-00401-000/BraTS-GLI-00401-000-seg.nii.gz,139,92,81,99,177,46,141,54,113,78,95,59
01241-000,../../DataSet/ASNR-MICCAI-BraTS2023-GLI-Challenge-TrainingData/BraTS-GLI-01241-000/BraTS-GLI-01241-000-t1c.nii.gz,../../DataSet/ASNR-MICCAI-BraTS2023-GLI-Challenge-TrainingData/BraTS-GLI-01241-000/BraTS-GLI-01241-000-t2w.nii.gz,../../DataSet/ASNR-MICCAI-BraTS2023-GLI-Challenge-TrainingData/BraTS-GLI-01241-000/BraTS-GLI-01241-000-t2f.nii.gz,../../DataSet/ASNR-MICCAI-BraTS2023-GLI-Challenge-TrainingData/BraTS-GLI-01241-000/BraTS-GLI-01241-000-t1n.nii.gz,../../DataSet/ASNR-MICCAI-BraTS2023-GLI-Challenge-TrainingData/BraTS-GLI-01241-000/BraTS-GLI-01241-000-seg.nii.gz,126,90,82,87,171,56,131,47,138,84,75,91
01290-000,../../DataSet/ASNR-MICCAI-BraTS2023-GLI-Challenge-TrainingData/BraTS-GLI-01290-000/BraTS-GLI-01290-000-t1c.nii.gz,../../DataSet/ASNR-MICCAI-BraTS2023-GLI-Challenge-TrainingData/BraTS-GLI-01290-000/BraTS-GLI-01290-000-t2w.nii.gz,../../DataSet/ASNR-MICCAI-BraTS2023-GLI-Challenge-TrainingData/BraTS-GLI-01290-000/BraTS-GLI-01290-000-t2f.nii.gz,../../DataSet/ASNR-MICCAI-BraTS2023-GLI-Challenge-TrainingData/BraTS-GLI-01290-000/BraTS-GLI-01290-000-t1n.nii.gz,../../DataSet/ASNR-MICCAI-BraTS2023-GLI-Challenge-TrainingData/BraTS-GLI-01290-000/BraTS-GLI-01290-000-seg.nii.gz,137,136,99,121,155,100,168,54,130,34,68,76
00377-000,../../DataSet/ASNR-MICCAI-BraTS2023-GLI-Challenge-TrainingData/BraTS-GLI-00377-000/BraTS-GLI-00377-000-t1c.nii.gz,../../DataSet/ASNR-MICCAI-BraTS2023-GLI-Challenge-TrainingData/BraTS-GLI-00377-000/BraTS-GLI-00377-000-t2w.nii.gz,../../DataSet/ASNR-MICCAI-BraTS2023-GLI-Challenge-TrainingData/BraTS-GLI-00377-000/BraTS-GLI-00377-000-t2f.nii.gz,../../DataSet/ASNR-MICCAI-BraTS2023-GLI-Challenge-TrainingData/BraTS-GLI-00377-000/BraTS-GLI-00377-000-t1n.nii.gz,../../DataSet/ASNR-MICCAI-BraTS2023-GLI-Challenge-TrainingData/BraTS-GLI-00377-000/BraTS-GLI-00377-000-seg.nii.gz,93,118,92,75,112,91,156,59,114,37,65,55
00552-001,../../DataSet/ASNR-MICCAI-BraTS2023-GLI-Challenge-TrainingData/BraTS-GLI-00552-001/BraTS-GLI-00552-001-t1c.nii.gz,../../DataSet/ASNR-MICCAI-BraTS2023-GLI-Challenge-TrainingData/BraTS-GLI-00552-001/BraTS-GLI-00552-001-t2w.nii.gz,../../DataSet/ASNR-MICCAI-BraTS2023-GLI-Challenge-TrainingData/BraTS-GLI-00552-001/BraTS-GLI-00552-001-t2f.nii.gz,../../DataSet/ASNR-MICCAI-BraTS2023-GLI-Challenge-TrainingData/BraTS-GLI-00552-001/BraTS-GLI-00552-001-t1n.nii.gz,../../DataSet/ASNR-MICCAI-BraTS2023-GLI-Challenge-TrainingData/BraTS-GLI-00552-001/BraTS-GLI-00552-001-seg.nii.gz,150,125,61,120,177,89,169,32,98,57,80,66
00716-000,../../DataSet/ASNR-MICCAI-BraTS2023-GLI-Challenge-TrainingData/BraTS-GLI-00716-000/BraTS-GLI-00716-000-t1c.nii.gz,../../DataSet/ASNR-MICCAI-BraTS2023-GLI-Challenge-TrainingData/BraTS-GLI-00716-000/BraTS-GLI-00716-000-t2w.nii.gz,../../DataSet/ASNR-MICCAI-BraTS2023-GLI-Challenge-TrainingData/BraTS-GLI-00716-000/BraTS-GLI-00716-000-t2f.nii.gz,../../DataSet/ASNR-MICCAI-BraTS2023-GLI-Challenge-TrainingData/BraTS-GLI-00716-000/BraTS-GLI-00716-000-t1n.nii.gz,../../DataSet/ASNR-MICCAI-BraTS2023-GLI-Challenge-TrainingData/BraTS-GLI-00716-000/BraTS-GLI-00716-000-seg.nii.gz,87,126,79,72,105,94,154,53,102,33,60,49
00694-001,../../DataSet/ASNR-MICCAI-BraTS2023-GLI-Challenge-TrainingData/BraTS-GLI-00694-001/BraTS-GLI-00694-001-t1c.nii.gz,../../DataSet/ASNR-MICCAI-BraTS2023-GLI-Challenge-TrainingData/BraTS-GLI-00694-001/BraTS-GLI-00694-001-t2w.nii.gz,../../DataSet/ASNR-MICCAI-BraTS2023-GLI-Challenge-TrainingData/BraTS-GLI-00694-001/BraTS-GLI-00694-001-t2f.nii.gz,../../DataSet/ASNR-MICCAI-BraTS2023-GLI-Challenge-TrainingData/BraTS-GLI-00694-001/BraTS-GLI-00694-001-t1n.nii.gz,../../DataSet/ASNR-MICCAI-BraTS2023-GLI-Challenge-TrainingData/BraTS-GLI-00694-001/BraTS-GLI-00694-001-seg.nii.gz,96,142,99,69,140,96,184,63,136,71,88,73
01156-000,../../DataSet/ASNR-MICCAI-BraTS2023-GLI-Challenge-TrainingData/BraTS-GLI-01156-000/BraTS-GLI-01156-000-t1c.nii.gz,../../DataSet/ASNR-MICCAI-BraTS2023-GLI-Challenge-TrainingData/BraTS-GLI-01156-000/BraTS-GLI-01156-000-t2w.nii.gz,../../DataSet/ASNR-MICCAI-BraTS2023-GLI-Challenge-TrainingData/BraTS-GLI-01156-000/BraTS-GLI-01156-000-t2f.nii.gz,../../DataSet/ASNR-MICCAI-BraTS2023-GLI-Challenge-TrainingData/BraTS-GLI-01156-000/BraTS-GLI-01156-000-t1n.nii.gz,../../DataSet/ASNR-MICCAI-BraTS2023-GLI-Challenge-TrainingData/BraTS-GLI-01156-000/BraTS-GLI-01156-000-seg.nii.gz,149,115,85,121,181,79,150,51,122,60,71,71
00253-000,../../DataSet/ASNR-MICCAI-BraTS2023-GLI-Challenge-TrainingData/BraTS-GLI-00253-000/BraTS-GLI-00253-000-t1c.nii.gz,../../DataSet/ASNR-MICCAI-BraTS2023-GLI-Challenge-TrainingData/BraTS-GLI-00253-000/BraTS-GLI-00253-000-t2w.nii.gz,../../DataSet/ASNR-MICCAI-BraTS2023-GLI-Challenge-TrainingData/BraTS-GLI-00253-000/BraTS-GLI-00253-000-t2f.nii.gz,../../DataSet/ASNR-MICCAI-BraTS2023-GLI-Challenge-TrainingData/BraTS-GLI-00253-000/BraTS-GLI-00253-000-t1n.nii.gz,../../DataSet/ASNR-MICCAI-BraTS2023-GLI-Challenge-TrainingData/BraTS-GLI-00253-000/BraTS-GLI-00253-000-seg.nii.gz,79,123,61,55,114,88,160,37,83,59,72,46
00195-000,../../DataSet/ASNR-MICCAI-BraTS2023-GLI-Challenge-TrainingData/BraTS-GLI-00195-000/BraTS-GLI-00195-000-t1c.nii.gz,../../DataSet/ASNR-MICCAI-BraTS2023-GLI-Challenge-TrainingData/BraTS-GLI-00195-000/BraTS-GLI-00195-000-t2w.nii.gz,../../DataSet/ASNR-MICCAI-BraTS2023-GLI-Challenge-TrainingData/BraTS-GLI-00195-000/BraTS-GLI-00195-000-t2f.nii.gz,../../DataSet/ASNR-MICCAI-BraTS2023-GLI-Challenge-TrainingData/BraTS-GLI-00195-000/BraTS-GLI-00195-000-t1n.nii.gz,../../DataSet/ASNR-MICCAI-BraTS2023-GLI-Challenge-TrainingData/BraTS-GLI-00195-000/BraTS-GLI-00195-000-seg.nii.gz,100,141,104,74,123,98,185,76,134,49,87,58
00144-000,../../DataSet/ASNR-MICCAI-BraTS2023-GLI-Challenge-TrainingData/BraTS-GLI-00144-000/BraTS-GLI-00144-000-t1c.nii.gz,../../DataSet/ASNR-MICCAI-BraTS2023-GLI-Challenge-TrainingData/BraTS-GLI-00144-000/BraTS-GLI-00144-000-t2w.nii.gz,../../DataSet/ASNR-MICCAI-BraTS2023-GLI-Challenge-TrainingData/BraTS-GLI-00144-000/BraTS-GLI-00144-000-t2f.nii.gz,../../DataSet/ASNR-MICCAI-BraTS2023-GLI-Challenge-TrainingData/BraTS-GLI-00144-000/BraTS-GLI-00144-000-t1n.nii.gz,../../DataSet/ASNR-MICCAI-BraTS2023-GLI-Challenge-TrainingData/BraTS-GLI-00144-000/BraTS-GLI-00144-000-seg.nii.gz,79,128,57,54,110,84,164,32,80,56,80,48
00525-000,../../DataSet/ASNR-MICCAI-BraTS2023-GLI-Challenge-TrainingData/BraTS-GLI-00525-000/BraTS-GLI-00525-000-t1c.nii.gz,../../DataSet/ASNR-MICCAI-BraTS2023-GLI-Challenge-TrainingData/BraTS-GLI-00525-000/BraTS-GLI-00525-000-t2w.nii.gz,../../DataSet/ASNR-MICCAI-BraTS2023-GLI-Challenge-TrainingData/BraTS-GLI-00525-000/BraTS-GLI-00525-000-t2f.nii.gz,../../DataSet/ASNR-MICCAI-BraTS2023-GLI-Challenge-TrainingData/BraTS-GLI-00525-000/BraTS-GLI-00525-000-t1n.nii.gz,../../DataSet/ASNR-MICCAI-BraTS2023-GLI-Challenge-TrainingData/BraTS-GLI-00525-000/BraTS-GLI-00525-000-seg.nii.gz,152,108,61,124,179,75,146,32,93,55,71,61
00282-000,../../DataSet/ASNR-MICCAI-BraTS2023-GLI-Challenge-TrainingData/BraTS-GLI-00282-000/BraTS-GLI-00282-000-t1c.nii.gz,../../DataSet/ASNR-MICCAI-BraTS2023-GLI-Challenge-TrainingData/BraTS-GLI-00282-000/BraTS-GLI-00282-000-t2w.nii.gz,../../DataSet/ASNR-MICCAI-BraTS2023-GLI-Challenge-TrainingData/BraTS-GLI-00282-000/BraTS-GLI-00282-000-t2f.nii.gz,../../DataSet/ASNR-MICCAI-BraTS2023-GLI-Challenge-TrainingData/BraTS-GLI-00282-000/BraTS-GLI-00282-000-t1n.nii.gz,../../DataSet/ASNR-MICCAI-BraTS2023-GLI-Challenge-TrainingData/BraTS-GLI-00282-000/BraTS-GLI-00282-000-seg.nii.gz,78,118,79,56,100,84,152,51,109,44,68,58
01365-000,../../DataSet/ASNR-MICCAI-BraTS2023-GLI-Challenge-TrainingData/BraTS-GLI-01365-000/BraTS-GLI-01365-000-t1c.nii.gz,../../DataSet/ASNR-MICCAI-BraTS2023-GLI-Challenge-TrainingData/BraTS-GLI-01365-000/BraTS-GLI-01365-000-t2w.nii.gz,../../DataSet/ASNR-MICCAI-BraTS2023-GLI-Challenge-TrainingData/BraTS-GLI-01365-000/BraTS-GLI-01365-000-t2f.nii.gz,../../DataSet/ASNR-MICCAI-BraTS2023-GLI-Challenge-TrainingData/BraTS-GLI-01365-000/BraTS-GLI-01365-000-t1n.nii.gz,../../DataSet/ASNR-MICCAI-BraTS2023-GLI-Challenge-TrainingData/BraTS-GLI-01365-000/BraTS-GLI-01365-000-seg.nii.gz,97,139,110,76,116,96,172,93,132,40,76,39
00254-000,../../DataSet/ASNR-MICCAI-BraTS2023-GLI-Challenge-TrainingData/BraTS-GLI-00254-000/BraTS-GLI-00254-000-t1c.nii.gz,../../DataSet/ASNR-MICCAI-BraTS2023-GLI-Challenge-TrainingData/BraTS-GLI-00254-000/BraTS-GLI-00254-000-t2w.nii.gz,../../DataSet/ASNR-MICCAI-BraTS2023-GLI-Challenge-TrainingData/BraTS-GLI-00254-000/BraTS-GLI-00254-000-t2f.nii.gz,../../DataSet/ASNR-MICCAI-BraTS2023-GLI-Challenge-TrainingData/BraTS-GLI-00254-000/BraTS-GLI-00254-000-t1n.nii.gz,../../DataSet/ASNR-MICCAI-BraTS2023-GLI-Challenge-TrainingData/BraTS-GLI-00254-000/BraTS-GLI-00254-000-seg.nii.gz,79,125,63,52,121,85,174,31,113,69,89,82
01414-000,../../DataSet/ASNR-MICCAI-BraTS2023-GLI-Challenge-TrainingData/BraTS-GLI-01414-000/BraTS-GLI-01414-000-t1c.nii.gz,../../DataSet/ASNR-MICCAI-BraTS2023-GLI-Challenge-TrainingData/BraTS-GLI-01414-000/BraTS-GLI-01414-000-t2w.nii.gz,../../DataSet/ASNR-MICCAI-BraTS2023-GLI-Challenge-TrainingData/BraTS-GLI-01414-000/BraTS-GLI-01414-000-t2f.nii.gz,../../DataSet/ASNR-MICCAI-BraTS2023-GLI-Challenge-TrainingData/BraTS-GLI-01414-000/BraTS-GLI-01414-000-t1n.nii.gz,../../DataSet/ASNR-MICCAI-BraTS2023-GLI-Challenge-TrainingData/BraTS-GLI-01414-000/BraTS-GLI-01414-000-seg.nii.gz,152,123,94,119,181,87,158,61,133,62,71,72
00285-000,../../DataSet/ASNR-MICCAI-BraTS2023-GLI-Challenge-TrainingData/BraTS-GLI-00285-000/BraTS-GLI-00285-000-t1c.nii.gz,../../DataSet/ASNR-MICCAI-BraTS2023-GLI-Challenge-TrainingData/BraTS-GLI-00285-000/BraTS-GLI-00285-000-t2w.nii.gz,../../DataSet/ASNR-MICCAI-BraTS2023-GLI-Challenge-TrainingData/BraTS-GLI-00285-000/BraTS-GLI-00285-000-t2f.nii.gz,../../DataSet/ASNR-MICCAI-BraTS2023-GLI-Challenge-TrainingData/BraTS-GLI-00285-000/BraTS-GLI-00285-000-t1n.nii.gz,../../DataSet/ASNR-MICCAI-BraTS2023-GLI-Challenge-TrainingData/BraTS-GLI-00285-000/BraTS-GLI-00285-000-seg.nii.gz,85,190,80,72,95,175,202,67,96,23,27,29
00228-000,../../DataSet/ASNR-MICCAI-BraTS2023-GLI-Challenge-TrainingData/BraTS-GLI-00228-000/BraTS-GLI-00228-000-t1c.nii.gz,../../DataSet/ASNR-MICCAI-BraTS2023-GLI-Challenge-TrainingData/BraTS-GLI-00228-000/BraTS-GLI-00228-000-t2w.nii.gz,../../DataSet/ASNR-MICCAI-BraTS2023-GLI-Challenge-TrainingData/BraTS-GLI-00228-000/BraTS-GLI-00228-000-t2f.nii.gz,../../DataSet/ASNR-MICCAI-BraTS2023-GLI-Challenge-TrainingData/BraTS-GLI-00228-000/BraTS-GLI-00228-000-t1n.nii.gz,../../DataSet/ASNR-MICCAI-BraTS2023-GLI-Challenge-TrainingData/BraTS-GLI-00228-000/BraTS-GLI-00228-000-seg.nii.gz,147,149,108,125,174,124,179,85,133,49,55,48
01468-000,../../DataSet/ASNR-MICCAI-BraTS2023-GLI-Challenge-TrainingData/BraTS-GLI-01468-000/BraTS-GLI-01468-000-t1c.nii.gz,../../DataSet/ASNR-MICCAI-BraTS2023-GLI-Challenge-TrainingData/BraTS-GLI-01468-000/BraTS-GLI-01468-000-t2w.nii.gz,../../DataSet/ASNR-MICCAI-BraTS2023-GLI-Challenge-TrainingData/BraTS-GLI-01468-000/BraTS-GLI-01468-000-t2f.nii.gz,../../DataSet/ASNR-MICCAI-BraTS2023-GLI-Challenge-TrainingData/BraTS-GLI-01468-000/BraTS-GLI-01468-000-t1n.nii.gz,../../DataSet/ASNR-MICCAI-BraTS2023-GLI-Challenge-TrainingData/BraTS-GLI-01468-000/BraTS-GLI-01468-000-seg.nii.gz,148,128,57,121,175,96,170,32,82,54,74,50
01009-000,../../DataSet/ASNR-MICCAI-BraTS2023-GLI-Challenge-TrainingData/BraTS-GLI-01009-000/BraTS-GLI-01009-000-t1c.nii.gz,../../DataSet/ASNR-MICCAI-BraTS2023-GLI-Challenge-TrainingData/BraTS-GLI-01009-000/BraTS-GLI-01009-000-t2w.nii.gz,../../DataSet/ASNR-MICCAI-BraTS2023-GLI-Challenge-TrainingData/BraTS-GLI-01009-000/BraTS-GLI-01009-000-t2f.nii.gz,../../DataSet/ASNR-MICCAI-BraTS2023-GLI-Challenge-TrainingData/BraTS-GLI-01009-000/BraTS-GLI-01009-000-t1n.nii.gz,../../DataSet/ASNR-MICCAI-BraTS2023-GLI-Challenge-TrainingData/BraTS-GLI-01009-000/BraTS-GLI-01009-000-seg.nii.gz,100,101,92,74,125,75,139,68,119,51,64,51
01246-000,../../DataSet/ASNR-MICCAI-BraTS2023-GLI-Challenge-TrainingData/BraTS-GLI-01246-000/BraTS-GLI-01246-000-t1c.nii.gz,../../DataSet/ASNR-MICCAI-BraTS2023-GLI-Challenge-TrainingData/BraTS-GLI-01246-000/BraTS-GLI-01246-000-t2w.nii.gz,../../DataSet/ASNR-MICCAI-BraTS2023-GLI-Challenge-TrainingData/BraTS-GLI-01246-000/BraTS-GLI-01246-000-t2f.nii.gz,../../DataSet/ASNR-MICCAI-BraTS2023-GLI-Challenge-TrainingData/BraTS-GLI-01246-000/BraTS-GLI-01246-000-t1n.nii.gz,../../DataSet/ASNR-MICCAI-BraTS2023-GLI-Challenge-TrainingData/BraTS-GLI-01246-000/BraTS-GLI-01246-000-seg.nii.gz,113,99,100,72,164,64,146,70,136,92,82,66
00406-000,../../DataSet/ASNR-MICCAI-BraTS2023-GLI-Challenge-TrainingData/BraTS-GLI-00406-000/BraTS-GLI-00406-000-t1c.nii.gz,../../DataSet/ASNR-MICCAI-BraTS2023-GLI-Challenge-TrainingData/BraTS-GLI-00406-000/BraTS-GLI-00406-000-t2w.nii.gz,../../DataSet/ASNR-MICCAI-BraTS2023-GLI-Challenge-TrainingData/BraTS-GLI-00406-000/BraTS-GLI-00406-000-t2f.nii.gz,../../DataSet/ASNR-MICCAI-BraTS2023-GLI-Challenge-TrainingData/BraTS-GLI-00406-000/BraTS-GLI-00406-000-t1n.nii.gz,../../DataSet/ASNR-MICCAI-BraTS2023-GLI-Challenge-TrainingData/BraTS-GLI-00406-000/BraTS-GLI-00406-000-seg.nii.gz,74,148,78,52,127,108,192,45,110,75,84,65
00370-000,../../DataSet/ASNR-MICCAI-BraTS2023-GLI-Challenge-TrainingData/BraTS-GLI-00370-000/BraTS-GLI-00370-000-t1c.nii.gz,../../DataSet/ASNR-MICCAI-BraTS2023-GLI-Challenge-TrainingData/BraTS-GLI-00370-000/BraTS-GLI-00370-000-t2w.nii.gz,../../DataSet/ASNR-MICCAI-BraTS2023-GLI-Challenge-TrainingData/BraTS-GLI-00370-000/BraTS-GLI-00370-000-t2f.nii.gz,../../DataSet/ASNR-MICCAI-BraTS2023-GLI-Challenge-TrainingData/BraTS-GLI-00370-000/BraTS-GLI-00370-000-t1n.nii.gz,../../DataSet/ASNR-MICCAI-BraTS2023-GLI-Challenge-TrainingData/BraTS-GLI-00370-000/BraTS-GLI-00370-000-seg.nii.gz,94,171,78,68,117,117,206,50,118,49,89,68
00555-001,../../DataSet/ASNR-MICCAI-BraTS2023-GLI-Challenge-TrainingData/BraTS-GLI-00555-001/BraTS-GLI-00555-001-t1c.nii.gz,../../DataSet/ASNR-MICCAI-BraTS2023-GLI-Challenge-TrainingData/BraTS-GLI-00555-001/BraTS-GLI-00555-001-t2w.nii.gz,../../DataSet/ASNR-MICCAI-BraTS2023-GLI-Challenge-TrainingData/BraTS-GLI-00555-001/BraTS-GLI-00555-001-t2f.nii.gz,../../DataSet/ASNR-MICCAI-BraTS2023-GLI-Challenge-TrainingData/BraTS-GLI-00555-001/BraTS-GLI-00555-001-t1n.nii.gz,../../DataSet/ASNR-MICCAI-BraTS2023-GLI-Challenge-TrainingData/BraTS-GLI-00555-001/BraTS-GLI-00555-001-seg.nii.gz,141,173,73,120,163,132,201,53,129,43,69,76
01530-000,../../DataSet/ASNR-MICCAI-BraTS2023-GLI-Challenge-TrainingData/BraTS-GLI-01530-000/BraTS-GLI-01530-000-t1c.nii.gz,../../DataSet/ASNR-MICCAI-BraTS2023-GLI-Challenge-TrainingData/BraTS-GLI-01530-000/BraTS-GLI-01530-000-t2w.nii.gz,../../DataSet/ASNR-MICCAI-BraTS2023-GLI-Challenge-TrainingData/BraTS-GLI-01530-000/BraTS-GLI-01530-000-t2f.nii.gz,../../DataSet/ASNR-MICCAI-BraTS2023-GLI-Challenge-TrainingData/BraTS-GLI-01530-000/BraTS-GLI-01530-000-t1n.nii.gz,../../DataSet/ASNR-MICCAI-BraTS2023-GLI-Challenge-TrainingData/BraTS-GLI-01530-000/BraTS-GLI-01530-000-seg.nii.gz,114,158,30,99,133,137,174,16,50,34,37,34
